"Player.name","position","Games","At.bat","Runs","Hits","Double..2B.","third.baseman","home.run","run.batted.in","a.walk","Strikeouts","stolen.base","Caught.stealing","AVG","On.base.Percentage","Slugging.Percentage","On.base.Plus.Slugging","Total_Bases","ISO","BB_K_Ratio","sb.attempts","SBSR","PA","totalRuns","OBP","SLG","AB_per_HR"
"B Bonds","LF",2986,9847,2227,2935,601,77,762,1996,2558,1539,514,141,0.298,0.444,0.607,1.0496906662259,5976,0.309,1.66211825860949,655,78.4732824427481,12405,4223,0.442805320435308,0.606885345790596,12.9225721784777
"H Aaron","RF",3298,12364,2174,3771,624,98,755,2297,1402,1383,240,73,0.305,0.374,0.555,0.930294012042949,6856,0.25,1.01373825018077,313,76.6773162939297,13766,4471,0.375780909487142,0.554513102555807,16.3761589403973
"B Ruth","RF",2504,8399,2174,2873,506,136,714,2213,2062,1330,123,117,0.342,0.474,0.69,1.16147718979887,5793,0.348,1.55037593984962,240,51.25,10461,4387,0.471752222540866,0.689724967258007,11.7633053221289
"A Pujols","1B",3080,11421,1914,3384,686,16,703,2218,1373,1404,117,43,0.296,0.374,0.544,0.91563769583405,6211,0.248,0.977920227920228,160,73.125,12794,4132,0.371814913240582,0.543822782593468,16.2460881934566
"A Rodriguez","SS",2784,10566,2021,3115,548,31,696,2086,1338,2287,329,76,0.295,0.38,0.55,0.924236834291977,5813,0.255,0.585045911674683,405,81.2345679012346,11904,4107,0.374075940860215,0.550160893431762,15.1810344827586
"W Mays","CF",2992,10881,2062,3283,523,140,660,1903,1464,1526,338,103,0.302,0.384,0.557,0.942013674275658,6066,0.255,0.959370904325033,441,76.6439909297052,12345,3965,0.384528149048198,0.557485525227461,16.4863636363636
"K Griffey","CF",2671,9801,1662,2781,524,38,630,1836,1312,1779,184,69,0.284,0.37,0.538,0.906109652819076,5271,0.254,0.737492973580663,253,72.7272727272727,11113,3498,0.368307387744084,0.537802265074992,15.5571428571429
"J Thome","1B",2543,8422,1583,2328,451,26,612,1699,1747,2548,19,20,0.276,0.402,0.554,0.954871610649181,4667,0.278,0.68563579277865,39,48.7179487179487,10169,3282,0.400727701838922,0.554143908810259,13.7614379084967
"S Sosa","RF",2354,8813,1475,2408,379,45,609,1667,929,2306,234,107,0.273,0.344,0.534,0.87629441659958,4704,0.261,0.402862098872507,341,68.6217008797654,9742,3142,0.342537466639294,0.533756949960286,14.4712643678161
"F Robinson","RF",2808,10006,1829,2943,528,72,586,1812,1420,1532,204,77,0.294,0.389,0.537,0.918826229205589,5373,0.243,0.926892950391645,281,72.5978647686833,11426,3641,0.381848415893576,0.536977813312013,17.0750853242321
"M McGwire","1B",1874,6187,1167,1626,252,6,583,1414,1317,1596,12,8,0.263,0.394,0.588,0.980359572464859,3639,0.325,0.825187969924812,20,60,7504,2581,0.392190831556503,0.588168740908356,10.6123499142367
"H Killebrew","1B",2435,8147,1283,2086,290,24,573,1584,1559,1699,19,18,0.256,0.376,0.509,0.884071650048937,4143,0.253,0.917598587404356,37,51.3513513513513,9706,2867,0.375540902534515,0.508530747514423,14.21815008726
"R Palmeiro","1B",2831,10472,1663,3020,585,38,569,1834,1353,1348,97,40,0.288,0.371,0.515,0.8843246220264,5388,0.227,1.00370919881306,137,70.8029197080292,11825,3497,0.369809725158562,0.514514896867838,18.4042179261863
"R Jackson","RF",2820,9864,1551,2584,463,49,563,1702,1375,2597,228,115,0.262,0.356,0.49,0.842320421149648,4834,0.228,0.529457065845206,343,66.4723032069971,11239,3253,0.352255538748999,0.490064882400649,17.5204262877442
"M Ramirez","LF",2302,8244,1544,2574,547,20,555,1831,1329,1813,38,33,0.312,0.411,0.585,0.993104621181814,4826,0.273,0.73303916161059,71,53.5211267605634,9573,3375,0.407709182074585,0.585395439107229,14.8540540540541
"M Schmidt","3B",2404,8352,1506,2234,408,59,548,1595,1507,1883,174,91,0.267,0.38,0.527,0.906749099078618,4404,0.26,0.800318640467339,265,65.6603773584906,9859,3101,0.379450248503905,0.527298850574713,15.2408759124088
"D Ortiz","DH",2408,8640,1419,2472,632,19,541,1768,1319,1750,17,9,0.286,0.38,0.552,0.932165338536146,4765,0.266,0.753714285714286,26,65.3846153846154,9959,3187,0.380660708906517,0.55150462962963,15.9704251386322
"M Mantle","CF",2401,8102,1677,2415,344,72,536,1509,1733,1710,153,38,0.298,0.421,0.557,0.97853512855977,4511,0.259,1.01345029239766,191,80.1047120418848,9835,3186,0.421759023894255,0.556776104665515,15.115671641791
"J Foxx","1B",2317,8134,1751,2646,458,125,534,1922,1452,1311,87,72,0.325,0.428,0.609,1.03679275535572,4956,0.284,1.10755148741419,159,54.7169811320755,9586,3673,0.427498435218026,0.609294320137694,15.2322097378277
"W McCovey","1B",2588,8197,1229,2211,353,46,521,1555,1345,1550,26,22,0.27,0.374,0.515,0.887368703913868,4219,0.245,0.867741935483871,48,54.1666666666667,9542,2784,0.372668203730874,0.514700500182994,15.7332053742802
"F Thomas","DH",2322,8199,1494,2468,495,12,521,1704,1667,1397,32,23,0.301,0.419,0.555,0.974061881585486,4550,0.254,1.1932712956335,55,58.1818181818182,9866,3198,0.419116156497061,0.554945725088425,15.7370441458733
"T Williams","LF",2292,7706,1798,2654,525,71,521,1839,2019,709,24,17,0.344,0.482,0.634,1.11430598932358,4884,0.29,2.84767277856135,41,58.5365853658537,9725,3637,0.480514138817481,0.633791850506099,14.7907869481766
"E Banks","1B",2528,9421,1305,2583,407,90,512,1636,763,1236,50,53,0.274,0.33,0.5,0.828076939144078,4706,0.226,0.617313915857605,103,48.5436893203884,10184,2941,0.328554595443833,0.499522343700244,18.400390625
"E Mathews","3B",2391,8537,1509,2315,354,72,512,1453,1444,1487,68,39,0.271,0.376,0.509,0.886045111575881,4349,0.238,0.971082716879623,107,63.5514018691589,9981,2962,0.376615569582206,0.509429541993675,16.673828125
"M Ott","RF",2730,9456,1859,2876,488,72,511,1860,1708,896,89,0,0.304,0.414,0.533,0.94370619455453,5041,0.229,1.90625,89,100,11164,3719,0.410605517735579,0.533100676818951,18.5048923679061
"G Sheffield","RF",2576,9217,1636,2689,467,27,509,1676,1475,1171,253,104,0.292,0.393,0.514,0.903391685714206,4737,0.222,1.25960717335611,357,70.8683473389356,10692,3312,0.389450056116723,0.513941629597483,18.1080550098232
"M Cabrera","DH",2702,10032,1530,3090,608,17,507,1848,1228,2033,40,21,0.308,0.384,0.524,0.907105751825066,5253,0.216,0.604033448106247,61,65.5737704918033,11260,3378,0.38348134991119,0.523624401913876,19.7869822485207
"E Murray","1B",3026,11336,1627,3255,560,35,504,1917,1333,1516,110,43,0.287,0.359,0.476,0.838237675881086,5397,0.189,0.879287598944591,153,71.8954248366013,12669,3544,0.362143815612913,0.476093860268172,22.4920634920635
"F McGriff","1B",2460,8757,1349,2490,441,24,493,1550,1305,1882,72,38,0.284,0.377,0.509,0.886240049616325,4458,0.225,0.693411264612115,110,65.4545454545455,10062,2899,0.377161598091831,0.509078451524495,17.762677484787
"L Gehrig","1B",2164,8001,1888,2721,534,163,493,1995,1508,790,102,101,0.34,0.447,0.632,1.07715751274071,5060,0.292,1.90886075949367,203,50.2463054187192,9509,3883,0.444736565359133,0.632420947381577,16.2292089249493
"A Beltr?","3B",2933,11068,1524,3166,636,38,477,1707,848,1732,121,42,0.286,0.339,0.48,0.816529130003265,5309,0.194,0.489607390300231,163,74.2331288343558,11916,3231,0.336858006042296,0.479671123960969,23.2033542976939
"W Stargell","LF",2360,7927,1195,2232,423,55,475,1540,937,1936,17,16,0.282,0.36,0.529,0.886086768636552,4190,0.247,0.483987603305785,33,51.5151515151515,8864,2735,0.357513537906137,0.528573230730415,16.6884210526316
"S Musial","OF",3026,10972,1949,3630,725,177,475,1951,1599,696,78,31,0.331,0.417,0.559,0.975016786171136,6134,0.228,2.29741379310345,109,71.5596330275229,12571,3900,0.415957362182802,0.559059423988334,23.0989473684211
"C Delgado","1B",2035,7283,1241,2038,483,18,473,1512,1109,1745,14,8,0.28,0.383,0.546,0.920928875463408,3976,0.266,0.635530085959885,22,63.6363636363636,8392,2753,0.375,0.545928875463408,15.3974630021142
"C Jones","3B",2499,8984,1619,2726,549,38,468,1623,1512,1409,150,46,0.303,0.401,0.529,0.9330471312143,4755,0.226,1.07310149041874,196,76.530612244898,10496,3242,0.403772865853659,0.529274265360641,19.1965811965812
"D Winfield","RF",2973,11003,1669,3110,540,88,465,1833,1216,1686,223,96,0.283,0.353,0.475,0.828545744694453,5221,0.192,0.721233689205219,319,69.9059561128527,12219,3502,0.354038792045176,0.474506952649277,23.6623655913979
"A Dunn","LF",2001,6883,1097,1631,334,10,462,1168,1317,2379,63,25,0.237,0.364,0.49,0.849269568360365,3371,0.253,0.55359394703657,88,71.5909090909091,8200,2265,0.359512195121951,0.489757373238414,14.8982683982684
"J Canseco","RF",1887,7057,1186,1877,340,14,462,1407,906,1942,200,88,0.266,0.353,0.515,0.864015983232355,3631,0.249,0.466529351184346,288,69.4444444444444,7963,2593,0.349491397714429,0.514524585517925,15.2748917748918
"N Cruz","DH",2008,7365,1081,2018,367,14,459,1302,732,1873,83,32,0.274,0.344,0.515,0.8542280249128,3790,0.241,0.390816871329418,115,72.1739130434783,8097,2383,0.33963196245523,0.51459606245757,16.0457516339869
"C Yastrzemski","LF",3308,11988,1816,3419,646,59,452,1844,1845,1393,168,116,0.285,0.379,0.462,0.842584668815421,5539,0.177,1.32447954055994,284,59.1549295774648,13833,3660,0.380539290103376,0.462045378712045,26.5221238938053
"V Guerrero","RF",2147,8155,1328,2590,477,46,449,1496,737,985,181,94,0.318,0.379,0.553,0.926700996466074,4506,0.235,0.748223350253807,275,65.8181818181818,8892,2824,0.374156545209177,0.552544451256898,18.162583518931
"J Bagwell","1B",2150,7797,1517,2314,488,32,449,1529,1401,1558,202,78,0.297,0.408,0.54,0.94422817714442,4213,0.243,0.899229781771502,280,72.1428571428571,9198,3046,0.403892150467493,0.540336026676927,17.3652561247216
"D Kingman","1B",1941,6677,901,1575,240,25,442,1210,608,1816,85,49,0.236,0.302,0.478,0.777566069777843,3191,0.242,0.334801762114537,134,63.4328358208955,7285,2111,0.299656829100892,0.477909240676951,15.106334841629
"J Giambi","1B",2260,7267,1227,2010,405,9,440,1441,1366,1572,20,12,0.277,0.399,0.516,0.907501769597688,3753,0.239,0.868956743002545,32,62.5,8633,2668,0.391057569790339,0.516444199807348,16.5159090909091
"P Konerko","1B",2349,8393,1162,2340,410,8,439,1412,921,1391,9,4,0.279,0.354,0.486,0.83659492770863,4083,0.207,0.662113587347232,13,69.2307692307692,9314,2574,0.350118101782263,0.486476825926367,19.1184510250569
"A Dawson","RF",2627,9927,1373,2774,503,98,438,1591,589,1509,314,109,0.279,0.323,0.482,0.802018609949244,4787,0.203,0.390324718356527,423,74.2316784869976,10516,2964,0.319798402434386,0.482220207514858,22.6643835616438
"C Beltr?n","CF",2586,9768,1582,2725,565,78,435,1587,1084,1795,312,49,0.279,0.35,0.486,0.837379319640654,4751,0.207,0.603899721448468,361,86.4265927977839,10852,3169,0.350995208256543,0.486384111384111,22.4551724137931
"J Gonzalez","RF",1689,6556,1061,1936,388,25,434,1404,457,1273,26,19,0.295,0.343,0.561,0.901931190806023,3676,0.266,0.358994501178319,45,57.7777777777778,7013,2465,0.341223442178811,0.560707748627212,15.1059907834101
"A Jones","CF",2196,7599,1204,1933,383,36,434,1289,891,1748,152,59,0.254,0.337,0.486,0.818216828790472,3690,0.232,0.509725400457666,211,72.0379146919431,8490,2493,0.332626619552415,0.485590209238058,17.5092165898618
"C Ripken Jr.","SS",3001,11551,1647,3184,603,44,431,1695,1129,1305,36,39,0.276,0.34,0.447,0.787549106731988,5168,0.171,0.865134099616858,75,48,12680,3342,0.340141955835962,0.447407150896026,26.800464037123
"M Piazza","C",1912,6911,1048,2127,344,8,427,1335,759,1113,17,20,0.308,0.377,0.545,0.921488955215096,3768,0.237,0.681940700808625,37,45.945945945946,7670,2383,0.376271186440678,0.545217768774418,16.1850117096019
"B Williams","OF",2488,9350,1410,2711,434,88,426,1475,1045,1046,90,49,0.29,0.361,0.492,0.853199219081572,4599,0.202,0.999043977055449,139,64.7482014388489,10395,2885,0.361327561327561,0.491871657754011,21.9483568075117
"E Encarnaci?n","DH",1960,7040,1099,1832,370,10,424,1261,903,1426,61,14,0.26,0.35,0.496,0.840635157600174,3494,0.236,0.633239831697055,75,81.3333333333333,7943,2360,0.344328339418356,0.496306818181818,16.6037735849057
"D Evans","3B",2687,8973,1344,2223,329,36,414,1354,1605,1410,99,68,0.248,0.361,0.431,0.792731253570379,3866,0.183,1.13829787234043,167,59.2814371257485,10578,2698,0.361883153715258,0.430848099855121,21.6739130434783
"A Soriano","LF",1975,7750,1152,2095,481,31,412,1159,496,1803,289,84,0.27,0.319,0.5,0.81408391947611,3874,0.23,0.275097060454798,373,77.4798927613941,8246,2311,0.314212951734174,0.499870967741935,18.8106796116505
"M Teixeira","1B",1862,6936,1099,1862,408,18,409,1298,918,1441,26,7,0.268,0.36,0.509,0.863331161341542,3533,0.241,0.63705759888966,33,78.7878787878788,7854,2397,0.353959765724472,0.50937139561707,16.958435207824
"D Snider","CF",2143,7161,1259,2116,358,85,407,1333,971,1237,99,50,0.295,0.38,0.54,0.919340499823022,3865,0.245,0.784963621665319,149,66.4429530201342,8132,2592,0.379611411706837,0.539729088116185,17.5945945945946
"A Kaline","RF",2834,10116,1622,3007,498,75,399,1583,1277,1020,137,65,0.297,0.376,0.48,0.855656583230766,4852,0.183,1.25196078431373,202,67.8217821782178,11393,3205,0.376020363381023,0.479636219849743,25.3533834586466
"A Galarraga","1B",2257,8096,1195,2333,444,32,399,1425,583,2003,128,81,0.288,0.347,0.499,0.834748230361142,4038,0.211,0.291063404892661,209,61.244019138756,8679,2620,0.335983408226754,0.498764822134387,20.2907268170426
"D Murphy","CF",2180,7960,1197,2111,350,39,398,1266,986,1748,161,68,0.265,0.346,0.469,0.815158089800669,3733,0.204,0.564073226544622,229,70.3056768558952,8946,2463,0.346188240554438,0.468969849246231,20
"J Carter","LF",2189,8422,1170,2184,432,53,396,1445,527,1387,231,66,0.259,0.306,0.464,0.767199146571595,3910,0.205,0.379956741167988,297,77.7777777777778,8949,2615,0.30293887585205,0.464260270719544,21.2676767676768
"J Edmonds","CF",2010,6858,1251,1949,437,25,393,1199,998,1729,67,50,0.284,0.376,0.527,0.902248901041138,3615,0.243,0.577212261422788,117,57.2649572649573,7856,2450,0.375127291242363,0.527121609798775,17.4503816793893
"G Nettles","3B",2700,8986,1193,2225,328,28,390,1314,1088,1209,32,36,0.248,0.329,0.421,0.749409455716547,3779,0.173,0.899917287014061,68,47.0588235294118,10074,2507,0.328866388723446,0.4205430669931,23.0410256410256
"J Bench","C",2158,7658,1091,2048,381,24,389,1376,891,1278,68,43,0.267,0.342,0.476,0.819625155048458,3644,0.209,0.697183098591549,111,61.2612612612613,8549,2467,0.34378289858463,0.475842256463829,19.6863753213368
"A Ramirez","3B",2194,8136,1098,2303,495,24,386,1417,633,1238,29,18,0.283,0.341,0.492,0.826949555133716,4004,0.209,0.511308562197092,47,61.7021276595745,8769,2515,0.334815828486715,0.492133726647001,21.0777202072539
"D Evans","RF",2606,8996,1470,2446,483,73,385,1384,1391,1697,78,59,0.272,0.37,0.47,0.839613044540447,4230,0.198,0.819681791396582,137,56.9343065693431,10387,2854,0.369404062770771,0.470208981769675,23.3662337662338
"H Baines","DH",2830,9908,1299,2866,488,49,384,1628,1062,1441,34,34,0.289,0.356,0.465,0.822742466792945,4604,0.176,0.736988202637058,68,50,10970,2927,0.358067456700091,0.464675010092854,25.8020833333333
"L Walker","RF",1988,6907,1355,2160,471,62,383,1311,913,1231,230,76,0.313,0.4,0.565,0.958190438033694,3904,0.252,0.741673436230707,306,75.1633986928105,7820,2666,0.392966751918159,0.565223686115535,18.0339425587467
"F Howard","LF",1895,6488,864,1774,245,35,382,1119,782,1460,8,9,0.273,0.352,0.499,0.850194666865673,3235,0.226,0.535616438356164,17,47.0588235294118,7270,1983,0.351581843191197,0.498612823674476,16.9842931937173
"R Howard","1B",1572,5707,848,1475,277,21,382,1194,709,1843,12,5,0.258,0.343,0.515,0.855555827445579,2940,0.257,0.384698860553445,17,70.5882352941177,6416,2042,0.340399002493766,0.515156824951814,14.9397905759162
"J Rice","LF",2089,8225,1249,2452,373,79,382,1451,670,1423,58,34,0.298,0.352,0.502,0.852989777734494,4129,0.204,0.470836261419536,92,63.0434782608696,8895,2700,0.350983698707139,0.502006079027356,21.5314136125654
"A Belle","LF",1539,5853,974,1726,389,21,381,1239,683,961,88,41,0.295,0.369,0.564,0.932387480418353,3300,0.269,0.710718002081165,129,68.2170542635659,6536,2213,0.368574051407589,0.563813429010764,15.3622047244094
"G Stanton","RF",1437,5249,817,1386,272,11,380,974,698,1697,42,15,0.264,0.354,0.537,0.887673977183928,2820,0.273,0.411314083677077,57,73.6842105263158,5947,1791,0.350428787624012,0.537245189559916,13.8131578947368
"O Cepeda","1B",2124,7927,1131,2351,417,27,379,1365,588,1169,142,80,0.297,0.35,0.499,0.844587927670291,3959,0.202,0.502994011976048,222,63.963963963964,8515,2496,0.345155607751028,0.499432319919263,20.9155672823219
"A Perez","1B",2777,9778,1272,2732,505,79,379,1652,925,1867,49,33,0.279,0.341,0.463,0.805169368979479,4532,0.184,0.495447241564006,82,59.7560975609756,10703,2924,0.341679902830982,0.463489466148497,25.7994722955145
"M Williams","3B",1866,7000,997,1878,338,35,378,1218,469,1363,53,35,0.268,0.317,0.489,0.802803588164413,3420,0.221,0.344093910491563,88,60.2272727272727,7469,2215,0.314232159592984,0.488571428571429,18.5185185185185
"N Cash","1B",2089,6705,1046,1820,241,41,377,1103,1043,1091,43,30,0.271,0.374,0.488,0.857807032639247,3274,0.217,0.956003666361137,73,58.9041095890411,7748,2149,0.369514713474445,0.488292319164802,17.7851458885942
"J Kent","2B",2298,8498,1320,2461,560,47,377,1518,801,1522,94,60,0.29,0.356,0.5,0.850437383329709,4246,0.21,0.526281208935611,154,61.038961038961,9299,2838,0.350790407570707,0.499646975759002,22.5411140583554
"C Fisk","C",2499,8756,1276,2356,421,47,376,1330,849,1386,128,58,0.269,0.341,0.457,0.790395769962395,3999,0.188,0.612554112554113,186,68.8172043010753,9605,2606,0.333680374804789,0.456715395157606,23.2872340425532
"R Colavito","RF",1841,6503,971,1730,283,21,374,1159,951,880,19,27,0.266,0.359,0.489,0.848216408013952,3177,0.223,1.08068181818182,46,41.304347826087,7454,2130,0.359672658975047,0.488543749038905,17.3877005347594
"G Hodges","1B",2072,7030,1105,1921,295,48,370,1274,943,1137,63,31,0.273,0.359,0.487,0.845983323160903,3422,0.214,0.829375549692172,94,67.0212765957447,7973,2379,0.359212341653079,0.486770981507824,19
"T Helton","1B",2247,7962,1401,2519,592,37,369,1406,1335,1175,37,29,0.316,0.414,0.539,0.953602863034717,4292,0.223,1.13617021276596,66,56.0606060606061,9297,2807,0.414542325481338,0.539060537553379,21.5772357723577
"R Kiner","LF",1472,5205,971,1451,216,39,369,1015,1011,749,22,2,0.279,0.398,0.548,0.94400932426869,2852,0.269,1.3497997329773,24,91.6666666666667,6216,1986,0.396074646074646,0.547934678194044,14.1056910569106
"L Berkman","1B",1879,6491,1146,1905,422,30,366,1234,1201,1300,86,48,0.293,0.406,0.537,0.940693394181615,3485,0.244,0.923846153846154,134,64.1791044776119,7692,2380,0.403796151846074,0.536897242335541,17.7349726775956
"J DiMaggio","CF",1736,6821,1390,2214,389,131,361,1537,790,369,30,9,0.325,0.398,0.579,0.973492655663872,3948,0.254,2.14092140921409,39,76.9230769230769,7611,2927,0.394691893312311,0.578800762351561,18.8947368421053
"G Gaetti","3B",2507,8951,1130,2280,443,39,360,1341,634,1602,96,65,0.255,0.308,0.434,0.737599532655243,3881,0.179,0.395755305867665,161,59.6273291925466,9585,2471,0.304016692749087,0.433582839906156,24.8638888888889
"J Mize","1B",1883,6443,1118,2011,367,83,359,1337,856,524,28,1,0.312,0.397,0.562,0.954798810405589,3621,0.25,1.63358778625954,29,96.551724137931,7299,2455,0.392793533360734,0.562005277044855,17.9470752089136
"Y Berra","C",2120,7555,1175,2150,321,49,358,1430,704,414,30,26,0.285,0.348,0.482,0.827759637141328,3643,0.197,1.70048309178744,56,53.5714285714286,8259,2605,0.345562416757477,0.482197220383852,21.1033519553073
"C Lee","LF",2099,7983,1125,2273,469,19,358,1363,655,984,125,47,0.285,0.339,0.483,0.821743252338981,3854,0.198,0.665650406504065,172,72.6744186046512,8638,2488,0.338967353554063,0.482775898784918,22.2988826815642
"G Vaughn","LF",1731,6103,1017,1475,284,23,355,1072,865,1513,121,59,0.242,0.337,0.47,0.806081423131761,2870,0.228,0.571711830799736,180,67.2222222222222,6968,2089,0.335820895522388,0.470260527609372,17.1915492957746
"L Gonzalez","LF",2591,9157,1412,2591,596,68,354,1439,1155,1218,128,87,0.283,0.367,0.479,0.842134722845749,4385,0.196,0.948275862068966,215,59.5348837209302,10312,2851,0.363266097750194,0.478868625095555,25.8672316384181
"L May","1B",2071,7609,959,2031,340,31,354,1244,487,1570,39,35,0.267,0.313,0.459,0.770342270724755,3495,0.192,0.310191082802548,74,52.7027027027027,8096,2203,0.311017786561265,0.459324484163491,21.4943502824859
"T Hunter","CF",2372,8857,1296,2452,498,39,353,1391,661,1741,195,99,0.277,0.331,0.461,0.788507435849518,4087,0.184,0.379666858127513,294,66.3265306122449,9518,2687,0.327064509350704,0.461442926498815,25.0906515580737
"R Braun","LF",1766,6622,1080,1963,408,49,352,1154,586,1363,216,60,0.296,0.358,0.532,0.885951370855095,3525,0.236,0.42993396918562,276,78.2608695652174,7208,2234,0.353634850166482,0.532316520688614,18.8125
"E Burks","CF",2000,7232,1253,2107,402,63,352,1206,793,1340,181,84,0.291,0.363,0.51,0.871741291732142,3691,0.219,0.591791044776119,265,68.3018867924528,8025,2459,0.361370716510903,0.510370575221239,20.5454545454545
"D Allen","1B",1749,6332,1099,1848,320,79,351,1119,894,1556,133,52,0.292,0.378,0.534,0.913101710867561,3379,0.242,0.574550128534704,185,71.8918918918919,7226,2218,0.379463050096872,0.533638660770689,18.039886039886
"M Trout","CF",1410,5105,1055,1547,298,51,351,898,922,1355,204,37,0.303,0.415,0.588,0.997315703233588,3000,0.285,0.680442804428044,241,84.6473029045643,6027,1953,0.409656545545047,0.587659157688541,14.5441595441595
"C Davis","OF",2436,8673,1240,2380,424,30,350,1372,1194,1698,142,98,0.274,0.36,0.451,0.813503091637632,3914,0.177,0.703180212014134,240,59.1666666666667,9867,2612,0.362217492652275,0.451285598985357,24.78
"G Foster","LF",1977,7023,986,1925,307,47,348,1239,666,1419,51,31,0.274,0.338,0.48,0.816826814342641,3370,0.206,0.469344608879493,82,62.1951219512195,7689,2225,0.336974899206659,0.479851915135982,20.1810344827586
"J Bautista","RF",1798,6051,1022,1496,312,17,344,975,1032,1394,70,32,0.247,0.361,0.475,0.831873729518211,2874,0.228,0.740315638450502,102,68.6274509803922,7083,1997,0.356910913454751,0.474962816063461,17.5901162790698
"C Granderson","CF",2057,7236,1217,1800,346,95,344,937,924,1916,153,50,0.249,0.337,0.465,0.799274054563782,3368,0.216,0.482254697286013,203,75.3694581280788,8160,2154,0.333823529411765,0.465450525152018,21.0348837209302
"J Votto","1B",1991,7044,1145,2093,453,22,342,1106,1338,1578,80,29,0.297,0.412,0.513,0.92267420614548,3616,0.216,0.847908745247148,109,73.394495412844,8382,2251,0.409329515628728,0.513344690516752,20.5964912280702
"R Santo","3B",2243,8143,1138,2254,365,67,342,1331,1109,1343,35,41,0.277,0.362,0.464,0.827568552907951,3779,0.187,0.825763216679077,76,46.0526315789474,9252,2469,0.36348897535668,0.464079577551271,23.8099415204678
"J Clark","RF",1994,6847,1118,1826,332,39,340,1180,1262,1442,77,61,0.267,0.379,0.476,0.856348175489704,3256,0.209,0.875173370319001,138,55.7971014492754,8109,2298,0.380811444074485,0.475536731415218,20.1382352941176
"B Powell","1B",2042,6681,889,1776,270,11,339,1187,1001,1226,20,21,0.266,0.361,0.462,0.823251624472108,3085,0.196,0.816476345840131,41,48.780487804878,7682,2076,0.361494402499349,0.461757221972759,19.7079646017699
"T Martinez","1B",2023,7111,1009,1925,365,21,339,1271,780,1069,27,20,0.271,0.344,0.471,0.813756073670117,3349,0.2,0.729653882132834,47,57.4468085106383,7891,2280,0.342795589912559,0.470960483757559,20.976401179941
"D Parker","RF",2466,9358,1272,2712,526,75,339,1493,683,1537,154,113,0.29,0.339,0.471,0.80883397305925,4405,0.181,0.444372153545869,267,57.6779026217228,10041,2765,0.338113733691863,0.470720239367386,27.6047197640118
"D Baylor","DH",2292,8198,1236,2135,366,28,338,1276,805,1069,285,120,0.26,0.342,0.436,0.762151861390596,3571,0.176,0.753040224508887,405,70.3703703703704,9003,2512,0.326557814061979,0.435594047328617,24.2544378698225
"J Adcock","1B",1959,6606,823,1832,295,35,336,1122,594,1059,20,25,0.277,0.337,0.485,0.82210944595822,3205,0.208,0.560906515580737,45,44.4444444444444,7200,1945,0.336944444444444,0.485165001513775,19.6607142857143
"R Can?","2B",2267,8773,1262,2639,572,33,335,1306,620,1214,51,38,0.301,0.351,0.488,0.835048955710572,4282,0.187,0.510708401976936,89,57.3033707865169,9393,2568,0.346960502501863,0.488088453208709,26.1880597014925
"D Strawberry","OF",1583,5418,898,1401,256,38,335,1000,816,1352,221,99,0.259,0.357,0.505,0.860982942467823,2738,0.246,0.603550295857988,320,69.0625,6234,1898,0.35563041385948,0.505352528608343,16.1731343283582
"B Bonds","RF",1849,7043,1258,1886,302,66,332,1024,914,1757,461,169,0.268,0.353,0.471,0.822713509221108,3316,0.203,0.520204894706887,630,73.1746031746032,7957,2282,0.351891416362951,0.470822092858157,21.2138554216867
"M Alou","LF",1942,7037,1109,2134,421,39,332,1287,737,894,106,37,0.303,0.369,0.516,0.88501066380032,3629,0.213,0.824384787472036,143,74.1258741258741,7774,2396,0.369307949575508,0.515702714224812,21.1957831325301
"H Greenberg","1B",1394,5193,1051,1628,379,71,331,1276,852,844,58,26,0.313,0.412,0.605,1.01530166348191,3142,0.292,1.00947867298578,84,69.0476190476191,6045,2327,0.41025641025641,0.605045253225496,15.6888217522659
"E Longoria","3B",1915,7102,993,1884,423,26,331,1131,707,1625,58,19,0.265,0.334,0.472,0.803776368918316,3352,0.207,0.435076923076923,77,75.3246753246753,7809,2124,0.331796644896914,0.471979724021402,21.4561933534743
"D Lee","1B",1942,6962,1081,1959,432,30,331,1078,874,1622,104,48,0.281,0.365,0.495,0.856221933433139,3444,0.214,0.538840937114673,152,68.4210526315789,7836,2159,0.361536498213374,0.494685435219764,21.0332326283988
"S Green","RF",1951,7082,1129,2003,445,35,328,1070,744,1315,162,52,0.283,0.355,0.494,0.845502536711169,3502,0.211,0.565779467680608,214,75.7009345794392,7826,2199,0.351009455660618,0.494493081050551,21.5914634146341
"M Vaughn","1B",1512,5532,861,1620,270,10,328,1064,725,1429,30,18,0.293,0.383,0.523,0.897918351691947,2894,0.23,0.507347795661302,48,62.5,6257,1925,0.374780246124341,0.523138105567607,16.8658536585366
"W Horton","LF",2028,7298,873,1993,284,40,325,1163,620,1313,20,38,0.273,0.332,0.457,0.786571019710044,3332,0.184,0.472201066260472,58,34.4827586206897,7918,2036,0.330007577671129,0.456563442038915,22.4553846153846
"J Upton","LF",1845,6721,1058,1754,350,38,325,1003,785,1971,151,59,0.261,0.342,0.469,0.807686915983258,3155,0.208,0.398274987316083,210,71.9047619047619,7506,2061,0.338262723154809,0.469424192828448,20.68
"J Dye","RF",1763,6487,984,1779,363,25,325,1072,597,1308,46,26,0.274,0.338,0.488,0.82361091030604,3167,0.214,0.456422018348624,72,63.8888888888889,7084,2056,0.335403726708075,0.488207183597965,19.96
"G Carter","C",2296,7971,1025,2092,371,31,324,1225,848,997,39,42,0.262,0.335,0.439,0.772086473632469,3497,0.177,0.850551654964895,81,48.1481481481481,8819,2250,0.333371130513664,0.438715343118806,24.6018518518519
"L Parrish","C",1988,7067,856,1782,305,27,324,1070,612,1527,28,37,0.252,0.313,0.44,0.752257433377289,3113,0.188,0.400785854616896,65,43.0769230769231,7679,1926,0.31175934366454,0.440498089712749,21.8117283950617
"R Gant","LF",1832,6449,1080,1651,302,50,321,1008,770,1411,243,102,0.256,0.336,0.468,0.803034415113491,3016,0.212,0.545712260807938,345,70.4347826086957,7219,2088,0.335365009004017,0.467669406109474,20.0903426791277
"V Castilla","3B",1854,6822,902,1884,349,28,320,1105,423,1069,33,43,0.276,0.321,0.476,0.794679799188231,3249,0.2,0.395696913002806,76,43.421052631579,7245,2007,0.318426501035197,0.476253298153034,21.31875
"S Finley","CF",2583,9397,1443,2548,449,124,304,1167,844,1299,320,118,0.271,0.332,0.442,0.773592880661926,4157,0.171,0.649730561970747,438,73.0593607305936,10241,2610,0.331217654525925,0.442375226136001,30.9111842105263
"R Hornsby","2B",2259,8173,1579,2930,541,169,301,1584,1038,679,135,64,0.358,0.434,0.577,1.00732175870612,4712,0.219,1.52871870397644,199,67.8391959798995,9211,3163,0.430789273694496,0.576532485011624,27.1528239202658
"C Klein","RF",1753,6486,1168,2076,398,74,300,1201,601,521,79,0,0.32,0.379,0.543,0.920749605112722,3522,0.223,1.15355086372361,79,100,7087,2369,0.377733878933258,0.543015726179463,21.62
"T Salmon","RF",1672,5934,986,1674,339,24,299,1016,970,1360,48,42,0.282,0.385,0.498,0.881449712773299,2958,0.216,0.713235294117647,90,53.3333333333333,6904,2002,0.382966396292005,0.498483316481294,19.8461538461538
"N Arenado","3B",1387,5281,806,1524,339,31,299,972,465,853,23,18,0.289,0.346,0.534,0.88052233696998,2822,0.245,0.545134818288394,41,56.0975609756098,5746,1778,0.346153846153846,0.534368490816133,17.6622073578595
"M Reynolds","3B",1688,5432,794,1283,253,14,298,871,707,1927,64,31,0.236,0.328,0.453,0.776660710717183,2458,0.217,0.366891541255838,95,67.3684210526316,6139,1665,0.324157028832057,0.452503681885125,18.2281879194631
"R Henderson","LF",3081,10961,2295,3055,510,66,297,1115,2190,1694,1406,335,0.279,0.401,0.419,0.81740393393015,4588,0.14,1.29279811097993,1741,80.7581849511775,13151,3410,0.398828986388868,0.418574947541283,36.9057239057239
"C Davis","1B",1417,4978,707,1160,228,5,295,780,555,1852,19,11,0.233,0.315,0.459,0.768576350073706,2283,0.226,0.299676025917927,30,63.3333333333333,5533,1487,0.309958431230797,0.458617918842909,16.8745762711864
"R Ventura","3B",2079,7064,1006,1885,338,14,294,1182,1075,1179,24,38,0.267,0.362,0.444,0.807197463188092,3133,0.177,0.911789652247668,62,38.7096774193548,8139,2188,0.363681041897039,0.443516421291053,24.0272108843537
"M Ordonez","RF",1848,6978,1076,2156,426,21,294,1236,651,852,94,50,0.309,0.369,0.502,0.870374358962221,3506,0.193,0.764084507042254,144,65.2777777777778,7629,2312,0.367938130816621,0.5024362281456,23.734693877551
"K Hrbek","1B",1747,6192,903,1749,312,18,293,1086,838,798,37,26,0.282,0.367,0.481,0.848614465138333,2976,0.199,1.05012531328321,63,58.7301587301587,7030,1989,0.367994310099573,0.48062015503876,21.1331058020478
"F Freeman","1B",1728,6394,1088,1908,414,27,292,1041,863,1417,66,28,0.298,0.386,0.509,0.890440039362726,3252,0.211,0.609033168666196,94,70.2127659574468,7257,2129,0.381838225161913,0.508601814200813,21.8972602739726
"P Burrell","LF",1640,5503,767,1393,299,16,292,976,932,1564,7,3,0.253,0.361,0.472,0.833774923362421,2600,0.219,0.595907928388747,10,70,6435,1743,0.361305361305361,0.47246956205706,18.8458904109589
"R Staub","OF",2951,9720,1189,2716,499,47,292,1466,1255,888,47,33,0.279,0.362,0.431,0.79237787901797,4185,0.152,1.41328828828829,80,58.75,10975,2655,0.361822323462415,0.430555555555556,33.2876712328767
"J Wynn","CF",1920,6653,1105,1665,285,39,291,964,1224,1427,225,101,0.25,0.366,0.436,0.802807886419795,2901,0.186,0.857743517869657,326,69.0184049079755,7877,2069,0.366763996445347,0.436043889974448,22.8625429553265
"C Biggio","2B",2850,10876,1844,3060,668,55,291,1175,1160,1753,414,124,0.281,0.363,0.433,0.783770394101501,4711,0.152,0.661722760981175,538,76.9516728624535,12036,3019,0.350614822200066,0.433155571901434,37.3745704467354
"B Johnson","LF",1863,6920,1239,2051,396,95,288,1283,1075,851,96,64,0.296,0.393,0.506,0.896919226973506,3501,0.21,1.26321974148061,160,60,7995,2522,0.390994371482176,0.505924855491329,24.0277777777778
"H Sauer","LF",1399,4796,709,1278,200,19,288,876,561,714,11,4,0.266,0.347,0.496,0.839536026771111,2380,0.23,0.785714285714286,15,73.3333333333333,5357,1585,0.34328915437745,0.496246872393661,16.6527777777778
"B Abreu","RF",2425,8480,1453,2470,574,59,288,1363,1476,1840,400,128,0.291,0.395,0.475,0.871108064161556,4026,0.184,0.802173913043478,528,75.7575757575758,9956,2816,0.39634391321816,0.474764150943396,29.4444444444444
"D Ennis","LF",1903,7254,985,2063,358,69,288,1284,597,719,45,19,0.284,0.34,0.472,0.810687927412322,3423,0.188,0.830319888734353,64,70.3125,7851,2269,0.338810342631512,0.471877584780811,25.1875
"B Williams","CF",2076,7869,1366,2336,449,55,287,1257,1069,1212,147,87,0.297,0.381,0.477,0.858273758983712,3756,0.18,0.882013201320132,234,62.8205128205128,8938,2623,0.380957708659655,0.477316050324056,27.418118466899
"G Anderson","LF",2228,8640,1084,2529,522,36,287,1365,429,1224,80,47,0.293,0.324,0.461,0.787277171316205,3984,0.168,0.350490196078431,127,62.992125984252,9069,2449,0.326166060205094,0.461111111111111,30.1045296167247
"A McCutchen","RF",1898,7043,1119,1950,393,49,287,1003,988,1543,205,84,0.277,0.369,0.469,0.834666703015945,3302,0.192,0.640311082307194,289,70.9342560553633,8031,2122,0.365832399452123,0.468834303563822,24.5400696864112
"B Bonilla","3B",2113,7213,1084,2010,408,61,287,1173,912,1204,45,57,0.279,0.358,0.472,0.831140543249901,3401,0.193,0.757475083056478,102,44.1176470588235,8125,2257,0.359630769230769,0.471509774019132,25.1324041811847
"B Giles","RF",1847,6527,1121,1897,411,55,287,1078,1183,835,109,45,0.291,0.4,0.502,0.901855944289678,3279,0.211,1.41676646706587,154,70.7792207792208,7710,2199,0.399481193255512,0.502374751034166,22.7421602787456
"M Kemp","CF",1750,6365,950,1808,338,37,287,1031,518,1641,184,63,0.284,0.337,0.484,0.821987457514267,3081,0.2,0.315661182205972,247,74.4939271255061,6883,1981,0.337934040389365,0.484053417124902,22.1777003484321
"C Pena","1B",1493,4949,745,1146,231,26,286,818,817,1577,29,22,0.232,0.346,0.462,0.802557540257838,2287,0.23,0.518072289156627,51,56.8627450980392,5766,1563,0.340443981963233,0.462113558294605,17.3041958041958
"F Thomas","LF",1766,6285,792,1671,262,31,286,962,484,894,15,22,0.266,0.32,0.454,0.772301073509693,2853,0.188,0.541387024608501,37,40.5405405405405,6769,1754,0.31836312601566,0.453937947494033,21.9755244755245
"B Harper","DH",1382,4927,913,1379,298,23,285,817,879,1276,122,43,0.28,0.39,0.523,0.912147319867656,2578,0.243,0.688871473354232,165,73.9393939393939,5806,1730,0.388908026179814,0.523239293687842,17.2877192982456
"W Clark","1B",1976,7173,1186,2176,440,47,284,1205,937,1190,67,48,0.303,0.384,0.497,0.880431516116661,3562,0.194,0.787394957983193,115,58.2608695652174,8110,2391,0.383847102342787,0.496584413773874,25.2570422535211
"R Zimmerman","3B",1799,6654,963,1846,417,22,284,1061,646,1384,43,16,0.277,0.341,0.475,0.816121891868523,3159,0.198,0.466763005780347,59,72.8813559322034,7300,2024,0.341369863013699,0.474752028854824,23.4295774647887
"E Karros","1B",1755,6441,797,1724,324,11,284,1027,552,1167,59,30,0.268,0.325,0.454,0.779124590023519,2922,0.186,0.473007712082262,89,66.2921348314607,6993,1824,0.325468325468325,0.453656264555193,22.6795774647887
"M Machado","3B",1449,5688,839,1601,312,18,283,855,514,1073,85,34,0.281,0.341,0.492,0.832931824995431,2798,0.211,0.479030754892824,119,71.4285714285714,6202,1694,0.341019026120606,0.491912798874824,20.0989399293286
"A Rizzo","1B",1539,5586,840,1479,313,22,283,891,722,1048,72,42,0.265,0.367,0.481,0.829587954395455,2685,0.216,0.688931297709924,114,63.1578947368421,6308,1731,0.348922003804692,0.480665950590763,19.7385159010601
"J Martinez","LF",1413,5301,792,1525,340,21,283,901,519,1431,25,11,0.288,0.352,0.52,0.87110465444178,2756,0.232,0.362683438155136,36,69.4444444444444,5820,1693,0.351202749140893,0.519901905300887,18.7314487632509
"A Jones","CF",1823,7009,963,1939,336,29,282,945,340,1395,97,35,0.277,0.317,0.454,0.763669928023067,3179,0.177,0.243727598566308,132,73.4848484848485,7349,1908,0.310110219077425,0.453559708945641,24.854609929078
"K Boyer","3B",2034,7455,1104,2143,318,68,282,1141,713,1017,105,77,0.287,0.349,0.462,0.81149489164829,3443,0.175,0.701081612586037,182,57.6923076923077,8168,2245,0.349657198824682,0.461837692823608,26.436170212766
"E Davis","CF",1626,5321,938,1430,239,26,282,934,740,1398,349,66,0.269,0.359,0.482,0.840454843278637,2567,0.213,0.529327610872675,415,84.0963855421687,6061,1872,0.358026728262663,0.482428115015974,18.8687943262411
"B McCann","C",1755,6067,742,1590,294,5,282,1018,640,1054,25,9,0.262,0.337,0.452,0.784111982076592,2740,0.19,0.607210626185958,34,73.5294117647059,6707,1760,0.332488444908305,0.451623537168287,21.5141843971631
"R Sandberg","2B",2164,8385,1318,2386,403,76,282,1061,761,1260,344,107,0.285,0.344,0.452,0.795724678869426,3787,0.167,0.603968253968254,451,76.2749445676275,9146,2379,0.344084845834244,0.451639833035182,29.7340425531915
"P O'Neill","RF",2053,7318,1041,2105,451,21,281,1269,892,1166,141,73,0.288,0.363,0.47,0.835253070948813,3441,0.182,0.765008576329331,214,65.8878504672897,8210,2310,0.365042630937881,0.470210440010932,26.0427046263345
"T Kluszewski","1B",1718,5929,848,1766,290,29,279,1028,492,365,20,10,0.298,0.353,0.498,0.849381676317239,2951,0.2,1.34794520547945,30,66.6666666666667,6421,1876,0.351658620152624,0.497723056164615,21.2508960573477
"R Klesko","1B",1736,5611,874,1564,343,33,278,987,817,1077,91,41,0.279,0.37,0.5,0.870678035199992,2807,0.221,0.758588672237697,132,68.9393939393939,6428,1861,0.370410703173615,0.500267332026377,20.1834532374101
"M Cameron","CF",1955,6839,1064,1700,383,59,278,968,867,1901,297,83,0.249,0.338,0.444,0.776895381813295,3035,0.195,0.456075749605471,380,78.1578947368421,7706,2032,0.333117051648066,0.443778330165229,24.6007194244604
"C Santana","1B",1787,6341,918,1535,334,16,278,925,1149,1249,48,18,0.242,0.359,0.431,0.789664440354579,2735,0.189,0.919935948759007,66,72.7272727272727,7490,1843,0.358344459279039,0.43131998107554,22.8093525179856
"R York","1B",1603,5891,876,1621,291,52,277,1152,792,867,38,26,0.275,0.362,0.483,0.844344968813844,2847,0.208,0.913494809688581,64,59.375,6683,2028,0.361065389795002,0.483279579018842,21.2671480144404
"R Maris","RF",1463,5101,826,1325,195,42,275,850,652,733,21,9,0.26,0.345,0.476,0.819827933930331,2429,0.216,0.889495225102319,30,70,5753,1676,0.343646792977577,0.476181140952754,18.5490909090909
"B Downing","DH",2344,7853,1188,2099,360,28,275,1073,1197,1127,50,44,0.267,0.37,0.425,0.789514061206155,3340,0.158,1.06211180124224,94,53.1914893617021,9050,2261,0.364198895027624,0.42531516617853,28.5563636363636
"D Palmer","3B",1357,4902,734,1229,231,15,275,849,502,1332,48,31,0.251,0.324,0.472,0.79257450470374,2315,0.221,0.376876876876877,79,60.7594936708861,5404,1583,0.320318282753516,0.472256221950224,17.8254545454545
"J Posada","C",1829,6092,900,1664,379,10,275,1065,936,1453,20,21,0.273,0.374,0.474,0.844013123007454,2888,0.201,0.644184445973847,41,48.780487804878,7028,1965,0.369948776323278,0.474064346684176,22.1527272727273
"L Parrish","3B",1891,6792,850,1789,360,33,256,992,529,1359,30,36,0.263,0.318,0.439,0.755816580535623,2983,0.176,0.38925680647535,66,45.4545454545455,7321,1842,0.316623412102172,0.439193168433451,26.53125
"B Allison","RF",1542,5032,811,1281,216,53,256,796,795,1033,84,50,0.255,0.358,0.471,0.827456944168954,2371,0.216,0.769603097773475,134,62.6865671641791,5827,1607,0.356272524455123,0.471184419713831,19.65625
"J Olerud","1B",2234,7592,1139,2239,500,13,255,1230,1275,1016,11,14,0.295,0.398,0.465,0.861264010016658,3530,0.17,1.25492125984252,25,44,8867,2369,0.396300890943949,0.464963119072708,29.7725490196078
"J Mayberry","1B",1620,5447,733,1379,211,19,255,879,881,810,20,15,0.253,0.36,0.439,0.796467255894464,2393,0.186,1.08765432098765,35,57.1428571428571,6328,1612,0.357142857142857,0.439324398751606,21.3607843137255
"K Gibson","LF",1635,5798,985,1553,260,54,255,870,718,1285,284,78,0.268,0.352,0.463,0.811789897703977,2686,0.195,0.55875486381323,362,78.4530386740332,6516,1855,0.348526703499079,0.463263194204898,22.7372549019608
"A LaRoche","1B",1605,5593,752,1452,340,13,255,882,649,1407,13,11,0.26,0.336,0.462,0.798418120375558,2583,0.202,0.461265103056148,24,54.1666666666667,6242,1634,0.336590836270426,0.461827284105131,21.9333333333333
"A Thornton","DH",1565,5291,792,1342,244,22,253,895,876,851,48,37,0.254,0.36,0.452,0.811177686319571,2389,0.198,1.02937720329025,85,56.4705882352941,6167,1687,0.359656234798119,0.451521451521452,20.9130434782609
"L Doby","CF",1533,5348,960,1515,243,52,253,970,871,1011,47,36,0.283,0.386,0.49,0.87375272150164,2621,0.207,0.861523244312562,83,56.6265060240964,6219,1930,0.383662968322881,0.490089753178758,21.1383399209486
"J Gordon","2B",1566,5707,914,1530,264,52,253,975,759,702,89,60,0.268,0.357,0.466,0.819574167549242,2657,0.198,1.08119658119658,149,59.7315436241611,6466,1889,0.354005567584287,0.465568599964955,22.5573122529644
"T Zeile","3B",2158,7573,986,2004,397,23,253,1110,945,1279,53,51,0.265,0.346,0.423,0.769554128033668,3206,0.158,0.738858483189992,104,50.9615384615385,8518,2096,0.346208030054003,0.423346097979665,29.9328063241107
"J Torre","C",2209,7874,996,2342,344,59,252,1185,779,1094,23,29,0.297,0.365,0.452,0.81280506002593,3560,0.155,0.712065813528336,52,44.2307692307692,8653,2181,0.360684155784121,0.452120904241809,31.2460317460317
"B Murcer","RF",1908,6730,972,1862,285,45,252,1043,862,841,127,75,0.277,0.357,0.445,0.803523846952372,2993,0.168,1.02497027348395,202,62.8712871287129,7592,2015,0.358798735511064,0.444725111441308,26.7063492063492
"B Boone","2B",1780,6683,927,1775,366,28,252,1021,552,1295,94,53,0.266,0.325,0.442,0.763498385417372,2953,0.176,0.426254826254826,147,63.9455782312925,7235,1948,0.321630960608155,0.441867424809217,26.5198412698413
"T Clark","1B",1559,4532,629,1188,233,11,251,824,527,1209,6,9,0.262,0.339,0.485,0.823554083003262,2196,0.223,0.435897435897436,15,40,5059,1453,0.338999802332477,0.484554280670786,18.0557768924303
"T Armas","CF",1432,5164,614,1302,204,39,251,815,260,1201,18,20,0.252,0.287,0.453,0.740535509049489,2337,0.201,0.216486261448793,38,47.3684210526316,5424,1429,0.287979351032448,0.452556158017041,20.5737051792829
"C Williams","OF",2003,6780,1024,1981,306,74,251,1005,690,721,115,82,0.292,0.365,0.47,0.827770077359586,3188,0.178,0.957004160887656,197,58.3756345177665,7470,2029,0.35756358768407,0.470206489675516,27.0119521912351
"R Yount","SS",2856,11008,1632,3142,583,126,251,1406,966,1350,271,105,0.285,0.342,0.43,0.772764166109905,4730,0.145,0.715555555555556,376,72.0744680851064,11974,3038,0.343076666109905,0.4296875,43.8565737051793
"J Valentin","SS",1678,5539,872,1348,302,41,249,816,630,1294,136,56,0.243,0.321,0.448,0.768189145296686,2479,0.205,0.486862442040185,192,70.8333333333333,6169,1688,0.32063543524072,0.447553710055967,22.2449799196787
"T Simmons","C",2456,8680,1074,2472,483,47,248,1389,855,694,21,33,0.285,0.348,0.437,0.785906579929873,3793,0.152,1.23198847262248,54,38.8888888888889,9535,2463,0.348925013109596,0.436981566820277,35
"G Goslin","LF",2287,8656,1482,2735,500,173,248,1609,949,585,175,89,0.316,0.387,0.5,0.883203653846339,4325,0.184,1.62222222222222,264,66.2878787878788,9605,3091,0.383550234252993,0.499653419593346,34.9032258064516
"V Stephens","SS",1720,6497,1001,1859,307,42,247,1174,692,685,25,22,0.286,0.355,0.46,0.815214006879878,2991,0.174,1.01021897810219,47,53.1914893617021,7189,2175,0.354847683961608,0.46036632291827,26.3036437246964
"J Morneau","1B",1545,5699,772,1603,349,23,247,985,573,988,5,10,0.281,0.348,0.481,0.827549408954668,2739,0.2,0.57995951417004,15,33.3333333333333,6272,1757,0.346938775510204,0.480610633444464,23.0728744939271
"V Martinez","DH",1973,7297,914,2153,423,3,246,1178,730,891,7,7,0.295,0.36,0.455,0.814144324710324,3320,0.16,0.819304152637486,14,50,8027,2092,0.359162825464059,0.454981499246266,29.6626016260163
"K Singleton","OF",2082,7189,985,2029,317,25,246,1065,1263,1246,21,36,0.282,0.388,0.436,0.82543741401206,3134,0.154,1.01364365971108,57,36.8421052631579,8452,2050,0.38949361097965,0.435943803032411,29.2235772357724
"D Johnson","1B",1765,5941,706,1447,247,33,245,923,584,1318,11,18,0.244,0.31,0.42,0.731227337013197,2495,0.176,0.44309559939302,29,37.9310344827586,6525,1629,0.311264367816092,0.419962969197105,24.2489795918367
"G Hartnett","C",1991,6432,867,1912,396,64,236,1179,703,697,28,7,0.297,0.37,0.489,0.855309123618069,3144,0.192,1.00860832137733,35,80,7135,2046,0.366503153468816,0.488805970149254,27.2542372881356
"B Nicholson","RF",1678,5546,837,1484,272,60,235,948,800,828,27,1,0.268,0.365,0.465,0.825292209818032,2581,0.197,0.966183574879227,28,96.4285714285714,6346,1785,0.359911755436495,0.465380454381536,23.6
"D Uggla","2B",1346,4759,759,1149,238,18,235,706,626,1341,26,21,0.241,0.336,0.447,0.776772076091764,2128,0.206,0.466815809097688,47,55.3191489361702,5385,1465,0.329619312906221,0.447152763185543,20.2510638297872
"B Oglivie","LF",1754,5913,784,1615,277,33,235,901,560,852,87,70,0.273,0.336,0.45,0.786374728741582,2663,0.177,0.657276995305164,157,55.4140127388535,6473,1685,0.336011123126835,0.450363605614747,25.1617021276596
"J Damon","CF",2490,9736,1668,2769,522,109,235,1139,1003,1257,408,103,0.284,0.352,0.433,0.784069755350739,4214,0.149,0.797931583134447,511,79.8434442270059,10739,2807,0.351243132507682,0.432826622843057,41.4297872340425
"K Mitchell","LF",1223,4134,630,1173,224,25,234,760,491,719,30,31,0.284,0.36,0.52,0.879619294185332,2149,0.236,0.682892906815021,61,49.1803278688525,4625,1390,0.359783783783784,0.519835510401548,17.6666666666667
"C Gonz?lez","RF",1377,5033,821,1432,302,40,234,785,448,1240,122,33,0.285,0.343,0.5,0.842903757296352,2516,0.215,0.361290322580645,155,78.7096774193548,5481,1606,0.343003101623791,0.499900655672561,21.508547008547
"G Matthews","LF",2032,7147,1083,2011,319,51,234,978,940,1125,183,74,0.281,0.364,0.439,0.803412307000186,3134,0.158,0.835555555555556,257,71.2062256809339,8087,2061,0.36490664028688,0.438505666713306,30.542735042735
"P Molitor","DH",2683,10835,1782,3319,605,114,234,1307,1094,1244,504,131,0.306,0.369,0.448,0.817931421114382,4854,0.142,0.879421221864952,635,79.3700787401575,11929,3089,0.369938804593847,0.447992616520535,46.3034188034188
"C Floyd","LF",1621,5318,824,1479,340,23,233,865,601,1064,148,43,0.278,0.358,0.482,0.833546852675339,2564,0.204,0.56484962406015,191,77.4869109947644,5919,1689,0.351410711268795,0.482136141406544,22.8240343347639
"J Rollins","SS",2275,9294,1421,2455,511,115,231,936,813,1264,470,105,0.264,0.324,0.418,0.741782264821286,3889,0.154,0.643196202531646,575,81.7391304347826,10107,2357,0.323340259226279,0.418442005595008,40.2337662337662
"R Deer","RF",1155,3881,578,853,148,13,230,600,575,1409,43,31,0.22,0.324,0.442,0.762878535904561,1717,0.222,0.408090844570617,74,58.1081081081081,4456,1178,0.320466786355476,0.442411749549085,16.8739130434783
"J Werth","RF",1583,5484,883,1465,300,22,229,799,764,1450,132,23,0.267,0.36,0.455,0.81189639327911,2496,0.188,0.526896551724138,155,85.1612903225806,6248,1682,0.356754161331626,0.455142231947484,23.9475982532751
"N Garciaparra","SS",1434,5586,927,1747,370,52,229,936,403,554,95,31,0.313,0.361,0.521,0.879578666629362,2908,0.208,0.727436823104693,126,75.3968253968254,5989,1863,0.358991484388045,0.520587182241318,24.3930131004367
"D Stuart","1B",1112,3997,506,1055,157,30,228,743,301,957,2,7,0.264,0.316,0.489,0.804862604608179,1956,0.225,0.314524555903866,9,22.2222222222222,4298,1249,0.315495579339228,0.489367025268952,17.530701754386
"H Johnson","3B",1531,4940,760,1229,247,22,228,760,692,1053,231,77,0.249,0.34,0.446,0.787240493881119,2204,0.197,0.657169990503324,308,75,5632,1520,0.341086647727273,0.446153846153846,21.6666666666667
"H Trosky","1B",1347,5161,835,1561,331,58,228,1012,545,440,28,23,0.302,0.371,0.522,0.890689513745716,2692,0.22,1.23863636363636,51,54.9019607843137,5706,1847,0.369085173501577,0.521604340244139,22.6359649122807
"M Grissom","CF",2165,8275,1187,2251,386,56,227,967,553,1240,429,116,0.272,0.318,0.415,0.732127246867629,3430,0.143,0.445967741935484,545,78.7155963302752,8828,2154,0.317625736293611,0.414501510574018,36.4537444933921
"J Callison","RF",1886,6652,926,1757,321,89,226,840,650,1064,74,51,0.264,0.331,0.441,0.770706071022643,2934,0.177,0.610902255639098,125,59.2,7302,1766,0.329635716242125,0.441070354780517,29.4336283185841
"T Tulowitzki","SS",1291,4804,762,1391,264,24,225,780,511,900,57,32,0.29,0.361,0.495,0.852859290196395,2378,0.205,0.567777777777778,89,64.0449438202247,5315,1542,0.357855126999059,0.495004163197336,21.3511111111111
"B Grich","2B",2008,6890,1033,1833,320,47,224,864,1087,1278,104,83,0.266,0.371,0.424,0.789709875252745,2919,0.158,0.850547730829421,187,55.6149732620321,7977,1897,0.366052400651874,0.423657474600871,30.7589285714286
"E Su?rez","3B",1155,4079,584,1019,179,13,224,635,467,1233,28,17,0.25,0.334,0.465,0.791700583083744,1896,0.215,0.37875101378751,45,62.2222222222222,4546,1219,0.326880774307083,0.464819808776661,18.2098214285714
"M Lowell","3B",1601,5813,771,1619,394,7,223,952,548,817,30,14,0.279,0.342,0.464,0.80445776726311,2696,0.185,0.670746634026928,44,68.1818181818182,6361,1723,0.340669706021066,0.463788061242044,26.067264573991
"S Perez","C",1257,4763,539,1278,238,11,223,732,181,915,6,1,0.268,0.301,0.463,0.758468604405453,2207,0.195,0.197814207650273,7,85.7142857142857,4944,1271,0.295105177993528,0.463363426411925,21.3587443946188
"T Fryman","3B",1698,6481,895,1776,345,40,223,1022,602,1369,72,38,0.274,0.336,0.443,0.778566342437825,2870,0.169,0.439737034331629,110,65.4545454545455,7083,1917,0.335733446279825,0.442832896158,29.0627802690583
"B Doerr","2B",1865,7093,1094,2042,381,89,223,1247,809,608,54,64,0.288,0.362,0.461,0.821812640486735,3270,0.173,1.33059210526316,118,45.7627118644068,7902,2341,0.360794735509997,0.461017904976738,31.8071748878924
"D Mattingly","1B",1785,7003,1007,2153,442,20,222,1099,588,444,14,9,0.307,0.358,0.471,0.832454909090752,3301,0.164,1.32432432432432,23,60.8695652173913,7591,2106,0.361085495982084,0.471369413108668,31.545045045045
"J Bay","LF",1278,4505,737,1200,240,30,222,754,636,1216,95,17,0.266,0.36,0.481,0.837928075334394,2166,0.215,0.523026315789474,112,84.8214285714286,5141,1491,0.357128963236724,0.480799112097669,20.2927927927928
"A Judge","RF",732,2651,538,754,121,4,222,501,472,913,40,15,0.284,0.395,0.584,0.976879053971381,1549,0.3,0.51697699890471,55,72.7272727272727,3123,1039,0.392571245597182,0.584307808374198,11.9414414414414
"G Springer","RF",1009,3915,719,1053,178,18,221,585,487,967,66,34,0.269,0.357,0.493,0.842816715727148,1930,0.224,0.503619441571872,100,66,4402,1304,0.349840981372104,0.492975734355045,17.7149321266968
"K Davis","LF",980,3394,506,820,164,9,221,590,328,1017,18,5,0.242,0.314,0.491,0.799007921492459,1665,0.249,0.32251720747296,23,78.2608695652174,3722,1096,0.30843632455669,0.490571596935769,15.3574660633484
"T Batista","3B",1309,4568,625,1146,226,17,221,718,287,790,47,26,0.251,0.299,0.453,0.748093079335763,2069,0.202,0.363291139240506,73,64.3835616438356,4855,1343,0.295159629248198,0.452933450087566,20.6696832579186
"G Jenkins","LF",1349,4700,688,1293,303,22,221,733,418,1186,32,14,0.275,0.344,0.49,0.82431027745213,2303,0.215,0.352445193929174,46,69.5652173913043,5118,1421,0.33431027745213,0.49,21.2669683257919
"T Oliva","RF",1676,6301,870,1917,329,48,220,947,448,645,86,55,0.304,0.353,0.476,0.826854597114307,3002,0.172,0.694573643410853,141,60.9929078014184,6749,1817,0.350422284782931,0.476432312331376,28.6409090909091
"J Pepitone","1B",1397,5097,606,1315,158,35,219,721,302,526,41,32,0.258,0.301,0.432,0.731126354319824,2200,0.174,0.574144486692015,73,56.1643835616438,5399,1327,0.299499907390257,0.431626446929566,23.2739726027397
"J Bottomley","1B",1991,7471,1177,2313,465,151,219,1422,664,591,58,15,0.31,0.369,0.5,0.866150376826865,3737,0.19,1.12351945854484,73,79.4520547945205,8135,2599,0.365949600491702,0.500200776335163,34.1141552511416
"A Oliver","CF",2368,9049,1189,2743,529,77,219,1326,535,756,84,64,0.303,0.344,0.451,0.793238459096099,4083,0.148,0.707671957671958,148,56.7567567567568,9584,2515,0.342028380634391,0.451210078461708,41.3196347031963
"B Horner","3B",1020,3777,560,1047,169,8,218,685,369,512,14,18,0.277,0.34,0.499,0.840872107703455,1886,0.222,0.720703125,32,43.75,4146,1245,0.341534008683068,0.499338099020387,17.3256880733945
"S Choo","RF",1652,6087,961,1671,339,29,218,782,868,1579,157,55,0.275,0.377,0.447,0.812243627242038,2722,0.172,0.549715009499683,212,74.0566037735849,6955,1743,0.365061107117182,0.447182520124856,27.9220183486239
"M Trumbo","1B",1097,4085,532,1018,182,11,218,629,299,1097,23,14,0.249,0.302,0.459,0.759651710012597,1876,0.21,0.272561531449407,37,62.1621621621622,4384,1161,0.300410583941606,0.459241126070991,18.7385321100917
"T Frazier","3B",1244,4392,604,1059,212,15,218,640,438,1085,73,38,0.241,0.318,0.445,0.755065392752492,1955,0.204,0.4036866359447,111,65.7657657657658,4830,1244,0.309937888198758,0.445127504553734,20.1467889908257
"B Santiago","C",1978,6951,755,1830,323,41,217,920,430,1270,91,69,0.263,0.307,0.415,0.721383631654184,2886,0.152,0.338582677165354,160,56.875,7381,1675,0.306191572957594,0.41519205869659,32.0322580645161
"M Sweeney","1B",1454,5188,759,1540,325,5,215,909,522,613,53,25,0.297,0.366,0.486,0.846857155202562,2520,0.189,0.851549755301794,78,67.948717948718,5710,1668,0.361120840630473,0.485736314572089,24.1302325581395
"R Fairly","1B",2442,7184,931,1913,307,33,215,1044,1052,877,35,33,0.266,0.36,0.408,0.767994834454851,2931,0.142,1.19954389965792,68,51.4705882352941,8236,1975,0.360004856726566,0.407989977728285,33.4139534883721
"P Guerrero","1B",1536,5392,730,1618,267,29,215,898,609,862,97,47,0.3,0.37,0.48,0.851075142273518,2588,0.18,0.706496519721578,144,67.3611111111111,6001,1628,0.371104815864023,0.479970326409496,25.0790697674419
"C Lemon","CF",1988,6868,973,1875,396,61,215,884,749,1024,58,76,0.273,0.355,0.442,0.78683387533434,3038,0.169,0.7314453125,134,43.2835820895522,7617,1857,0.344492582381515,0.442341292952825,31.9441860465116
"J Conine","1B",2024,6957,870,1982,385,36,214,1071,671,1168,54,29,0.285,0.347,0.443,0.790660890982203,3081,0.158,0.574486301369863,83,65.0602409638554,7628,1941,0.347797587834295,0.442863303147909,32.5093457943925
"J Guillen","RF",1650,5888,748,1591,305,25,214,887,321,1103,31,26,0.27,0.321,0.44,0.747478130448788,2588,0.17,0.29102447869447,57,54.3859649122807,6209,1635,0.307940086970527,0.439538043478261,27.5140186915888
"M Betts","RF",1117,4473,873,1309,308,33,214,650,522,696,158,34,0.293,0.369,0.52,0.886351945506875,2325,0.227,0.75,192,82.2916666666667,4995,1523,0.366566566566567,0.519785378940309,20.9018691588785
"T Hafner","DH",1183,4058,619,1107,250,13,213,731,598,976,11,7,0.273,0.376,0.498,0.864469170396942,2022,0.225,0.612704918032787,18,61.1111111111111,4656,1350,0.366194158075601,0.498275012321341,19.0516431924883
"A Pafko","CF",1852,6292,844,1796,264,62,213,976,561,477,38,13,0.285,0.35,0.449,0.792601933306734,2823,0.164,1.17610062893082,51,74.5098039215686,6853,1820,0.34393696191449,0.448664971392244,29.5399061032864
"K Morales","DH",1363,4856,584,1289,257,7,213,740,417,978,6,15,0.265,0.327,0.453,0.776376834709538,2199,0.188,0.426380368098159,21,28.5714285714286,5273,1324,0.323534989569505,0.452841845140033,22.7981220657277
"B Skowron","1B",1658,5547,681,1566,243,53,211,888,383,870,16,18,0.282,0.332,0.459,0.788015185882043,2548,0.177,0.440229885057471,34,47.0588235294118,5930,1569,0.328667790893761,0.459347394988282,26.2890995260664
"B Phillips","2B",1902,7378,1005,2029,368,35,211,951,420,1092,209,84,0.275,0.32,0.42,0.734222953095062,3100,0.145,0.384615384615385,293,71.3310580204778,7798,1956,0.314054885868171,0.420168067226891,34.9668246445498
"K McReynolds","LF",1502,5423,727,1439,284,35,211,807,522,707,93,32,0.265,0.328,0.447,0.777210885883522,2426,0.182,0.738330975954738,125,74.4,5945,1534,0.329857022708158,0.447353863175364,25.7014218009479
"L Wagner","LF",1352,4426,636,1202,150,15,211,669,435,656,54,24,0.272,0.34,0.455,0.79202633017126,2015,0.183,0.663109756097561,78,69.2307692307692,4861,1305,0.336761983131043,0.455264347040217,20.9763033175355
"W Post","RF",1205,4007,594,1064,194,28,210,699,331,813,19,13,0.266,0.323,0.485,0.806727749260371,1944,0.219,0.407134071340713,32,59.375,4338,1293,0.321576763485477,0.485150985774894,19.0809523809524
"R Petrocelli","SS",1553,5390,653,1352,237,22,210,773,661,926,10,22,0.251,0.332,0.42,0.752523862567067,2263,0.169,0.713822894168467,32,31.25,6051,1426,0.332672285572633,0.419851576994434,25.6666666666667
"R Alomar","2B",2379,9073,1508,2724,504,80,210,1134,1032,1140,474,114,0.3,0.371,0.443,0.814549598880006,4018,0.143,0.905263157894737,588,80.6122448979592,10105,2642,0.371697179614052,0.442852419265954,43.2047619047619
"B Anderson","RF",1834,6499,1062,1661,338,67,210,761,960,1190,315,100,0.256,0.362,0.425,0.776529915056388,2763,0.169,0.80672268907563,415,75.9036144578313,7459,1823,0.351387585467221,0.425142329589168,30.947619047619
"P Nevin","3B",1217,4188,584,1131,209,6,208,743,449,1019,18,5,0.27,0.343,0.472,0.812561805616919,1976,0.202,0.44062806673209,23,78.2608695652174,4637,1327,0.340737545827043,0.471824259789876,20.1346153846154
"J Thompson","1B",1418,4802,640,1253,204,12,208,782,816,862,8,7,0.261,0.366,0.438,0.806639543954111,2105,0.177,0.946635730858469,15,53.3333333333333,5618,1422,0.368280526877892,0.438359017076218,23.0865384615385
"D White","CF",1941,7344,1125,1934,378,71,208,846,541,1526,346,98,0.263,0.319,0.419,0.733004774516021,3078,0.156,0.354521625163827,444,77.9279279279279,7885,1971,0.313887127457197,0.419117647058824,35.3076923076923
"C Blackmon","RF",1408,5373,884,1597,288,58,208,712,403,1004,138,56,0.297,0.355,0.489,0.834814268325314,2625,0.192,0.401394422310757,194,71.1340206185567,5776,1596,0.346260387811634,0.488553880513679,25.8317307692308
"K Puckett","CF",1783,7244,1071,2304,414,57,207,1085,450,965,134,76,0.318,0.36,0.477,0.834611600798459,3453,0.159,0.466321243523316,210,63.8095238095238,7694,2156,0.357941252924357,0.476670347874103,34.9951690821256
"R Zisk","RF",1453,5144,681,1477,245,26,207,792,533,910,8,15,0.287,0.353,0.466,0.819651222868408,2395,0.179,0.585714285714286,23,34.7826086956522,5677,1473,0.354060243086137,0.465590979782271,24.8502415458937
"G Bell","CF",1741,6478,865,1823,311,66,206,942,470,636,30,31,0.281,0.33,0.445,0.775222163745216,2884,0.164,0.738993710691824,61,49.1803278688525,6948,1807,0.330023028209557,0.445199135535659,31.4466019417476
"F Alou","RF",2082,7339,985,2101,359,49,206,852,423,706,107,67,0.286,0.328,0.433,0.757930430582341,3176,0.147,0.599150141643059,174,61.4942528735632,7762,1837,0.325173924246328,0.432756506336013,35.626213592233
"P Incaviglia","LF",1284,4233,546,1043,194,21,206,655,360,1277,33,26,0.246,0.31,0.448,0.753610361066196,1897,0.202,0.281910728269381,59,55.9322033898305,4593,1201,0.305464837796647,0.448145523269549,20.5485436893204
"J Medwick","LF",1984,7635,1198,2471,540,113,205,1383,437,551,42,0,0.324,0.362,0.505,0.864776344919302,3852,0.181,0.793103448275862,42,100,8072,2581,0.360257680872151,0.504518664047151,37.2439024390244
"J Cruz Jr.","CF",1388,4724,713,1167,252,36,204,624,658,1147,113,39,0.247,0.337,0.445,0.784266855586297,2103,0.198,0.573670444638187,152,74.3421052631579,5382,1337,0.339093273875883,0.445173581710415,23.156862745098
"R Carty","LF",1651,5606,712,1677,278,17,204,890,642,663,21,26,0.299,0.369,0.464,0.835125948830204,2601,0.165,0.968325791855204,47,44.6808510638298,6248,1602,0.371158770806658,0.463967178023546,27.4803921568627
"W Joyner","1B",2033,7127,973,2060,409,26,204,1106,833,825,60,39,0.289,0.362,0.44,0.803038113959724,3133,0.151,1.00969696969697,99,60.6060606060606,7960,2079,0.363442211055276,0.439595902904448,34.9362745098039
"R Hebner","3B",1908,6144,865,1694,273,57,203,890,687,741,38,40,0.276,0.352,0.438,0.786383565043551,2690,0.162,0.927125506072874,78,48.7179487179487,6831,1755,0.348558044210218,0.437825520833333,30.2660098522167
"M Moustakas","1B",1317,4711,553,1165,259,6,203,635,378,874,21,10,0.247,0.308,0.434,0.737293413495355,2045,0.187,0.432494279176201,31,67.741935483871,5089,1188,0.303202986834349,0.434090426661006,23.2068965517241
"B Dickey","C",1789,6300,930,1969,343,72,202,1209,678,289,36,29,0.313,0.382,0.486,0.865366799055535,3062,0.173,2.34602076124567,65,55.3846153846154,6978,2139,0.379335053023789,0.486031746031746,31.1881188118812
"S Gordon","LF",1475,4992,735,1415,220,43,202,805,731,356,19,5,0.283,0.377,0.466,0.841123991641913,2327,0.183,2.05337078651685,24,79.1666666666667,5723,1540,0.374978158308579,0.466145833333333,24.7128712871287
"C Everett","CF",1405,4809,707,1304,258,26,202,791,442,1021,107,54,0.271,0.341,0.462,0.794142529130001,2220,0.191,0.432908912830558,161,66.4596273291926,5251,1498,0.332508093696439,0.461634435433562,23.8069306930693
"T Hundley","C",1225,3769,495,883,167,7,202,599,453,988,14,11,0.234,0.32,0.443,0.759526059595853,1670,0.209,0.458502024291498,25,56,4222,1094,0.31643770724775,0.443088352348103,18.6584158415842
"B White","1B",1673,5972,843,1706,278,65,202,870,596,927,103,68,0.286,0.351,0.455,0.805946018488227,2720,0.169,0.642934196332255,171,60.233918128655,6568,1713,0.350487210718636,0.455458807769591,29.5643564356436
"J Peralta","SS",1798,6599,841,1761,376,24,202,873,606,1450,17,27,0.267,0.329,0.423,0.751464729951408,2791,0.156,0.417931034482759,44,38.6363636363636,7205,1714,0.32852185981957,0.422942870131838,32.6683168316832
"B Bell","3B",2405,8995,1151,2514,425,56,201,1106,836,776,55,79,0.279,0.341,0.406,0.746984505061611,3654,0.127,1.07731958762887,134,41.044776119403,9831,2257,0.340758824127759,0.406225680933852,44.7512437810945
"G Tenace","C",1555,4390,653,1060,179,20,201,674,984,998,36,42,0.241,0.388,0.429,0.809051427060011,1882,0.188,0.985971943887776,78,46.1538461538462,5374,1327,0.380349832526982,0.42870159453303,21.8407960199005
"D Mincher","1B",1400,4026,530,1003,176,16,200,643,606,668,24,32,0.249,0.348,0.45,0.797192278685951,1811,0.201,0.907185628742515,56,42.8571428571429,4632,1173,0.347366148531952,0.449826130153999,20.13
"J Hamilton","CF",1027,3909,609,1134,234,24,200,701,352,938,50,16,0.29,0.349,0.516,0.864477350212524,2016,0.226,0.375266524520256,66,75.7575757575758,4261,1310,0.348744426191035,0.515732924021489,19.545
"A Lind","1B",1344,4577,588,1247,259,12,200,723,393,945,7,5,0.272,0.33,0.465,0.795350209186076,2130,0.193,0.415873015873016,12,58.3333333333333,4970,1311,0.329979879275654,0.465370329910422,22.885
"O Gamble","OF",1584,4502,656,1195,188,31,200,666,610,544,47,37,0.265,0.356,0.454,0.807333325685889,2045,0.189,1.12132352941176,84,55.952380952381,5112,1322,0.353090766823161,0.454242558862728,22.51
"B Freehan","C",1774,6073,706,1591,241,35,200,758,626,753,24,21,0.262,0.34,0.412,0.742932402743778,2502,0.15,0.831341301460823,45,53.3333333333333,6699,1464,0.330944917151814,0.411987485591964,30.365
"J Uribe","SS",1826,6161,724,1568,323,43,199,816,388,1224,48,39,0.255,0.301,0.418,0.716460872824439,2574,0.163,0.316993464052288,87,55.1724137931034,6549,1540,0.298671552908841,0.417789319915598,30.9597989949749
"J Jensen","RF",1438,5236,810,1463,259,45,199,929,750,546,143,55,0.279,0.369,0.46,0.82977999084699,2409,0.181,1.37362637362637,198,72.2222222222222,5986,1739,0.369695957233545,0.460084033613445,26.3115577889447
"C Cedeno","CF",2006,7310,1084,2087,436,60,199,976,664,938,550,179,0.285,0.347,0.443,0.788224691945128,3240,0.158,0.707889125799574,729,75.4458161865569,7974,2060,0.344996237772761,0.443228454172367,36.7336683417085
"K Schwarber","LF",822,2795,471,649,111,11,199,445,424,923,22,12,0.232,0.338,0.493,0.826714370900417,1379,0.261,0.459371614301192,34,64.7058823529412,3219,916,0.333333333333333,0.493381037567084,14.0452261306533
"B Larkin","SS",2180,7937,1329,2340,441,76,198,960,939,817,379,77,0.295,0.371,0.444,0.813797612371377,3527,0.149,1.14932680538556,456,83.1140350877193,8876,2289,0.369423163587201,0.444374448784175,40.0858585858586
"R White","LF",1474,5357,756,1519,296,34,198,768,360,925,94,47,0.284,0.336,0.462,0.791054545898613,2477,0.178,0.389189189189189,141,66.6666666666667,5717,1524,0.328668882280917,0.462385663617696,27.0555555555556
"D Henderson","CF",1538,5130,710,1324,286,17,197,708,465,1105,50,38,0.258,0.32,0.436,0.755422291206121,2235,0.178,0.420814479638009,88,56.8181818181818,5595,1418,0.319749776586238,0.435672514619883,26.0406091370558
"M Cuddyer","RF",1536,5488,809,1522,333,42,197,794,527,1101,75,22,0.277,0.344,0.461,0.801654209956159,2530,0.184,0.478655767484105,97,77.319587628866,6015,1603,0.340648379052369,0.46100583090379,27.8578680203046
"D McAuliffe","2B",1763,6185,888,1530,231,71,197,697,882,974,63,59,0.247,0.343,0.403,0.744538285190175,2494,0.156,0.905544147843943,122,51.6393442622951,7067,1585,0.341304655440781,0.403233629749394,31.3959390862944
"M Ozuna","LF",1166,4434,583,1187,201,20,197,677,379,1044,28,14,0.268,0.326,0.455,0.780713853745789,2019,0.187,0.363026819923372,42,66.6666666666667,4813,1260,0.325368792852691,0.455345060893099,22.507614213198
"E Hosmer","1B",1660,6262,805,1731,319,20,196,879,556,1212,76,30,0.276,0.336,0.428,0.76309450653806,2678,0.152,0.458745874587459,106,71.6981132075472,6818,1684,0.33543561161631,0.42765889492175,31.9489795918367
"C Johnson","DH",1369,3945,539,1016,188,10,196,699,568,719,9,12,0.258,0.355,0.459,0.810301629681554,1812,0.201,0.789986091794159,21,42.8571428571429,4513,1238,0.350986040327942,0.459315589353612,20.1275510204082
"J Smoak","1B",1286,4153,505,951,196,2,196,570,552,1122,3,3,0.229,0.322,0.419,0.738180842088725,1739,0.19,0.491978609625668,6,50,4705,1075,0.319447396386823,0.418733445701902,21.1887755102041
"K Williams","OF",1398,4862,862,1552,285,77,196,913,566,287,154,106,0.319,0.393,0.53,0.920639116399661,2579,0.211,1.97212543554007,260,59.2307692307692,5428,1775,0.390198968312454,0.530440148087207,24.8061224489796
"A Cabrera","SS",1822,6632,886,1763,401,28,195,869,589,1330,91,32,0.266,0.329,0.423,0.748665996292478,2805,0.157,0.442857142857143,123,73.9837398373984,7221,1755,0.325716659742418,0.42294933655006,34.0102564102564
"T Harrah","3B",2155,7402,1115,1954,307,40,195,918,1154,868,238,94,0.264,0.365,0.395,0.758552424897103,2926,0.131,1.3294930875576,332,71.6867469879518,8556,2033,0.363253856942497,0.395298567954607,37.9589743589744
"J Willingham","LF",1147,3912,564,988,216,15,195,632,553,1036,35,9,0.253,0.358,0.465,0.810108329497546,1819,0.212,0.533783783783784,44,79.5454545454545,4465,1196,0.345128779395297,0.46497955010225,20.0615384615385
"J Bell","SS",2063,7398,1123,1963,394,67,195,860,853,1443,91,60,0.265,0.343,0.416,0.757080015434897,3076,0.151,0.591129591129591,151,60.2649006622517,8251,1983,0.34129196461035,0.415788050824547,37.9384615384615
"J Heath","LF",1383,4937,777,1447,279,102,194,887,593,670,56,47,0.293,0.37,0.509,0.877707944696302,2512,0.216,0.885074626865672,103,54.3689320388349,5530,1664,0.368896925858951,0.508811018837351,25.4484536082474
"R Branyan","3B",1059,2934,405,682,143,8,194,467,403,1118,16,4,0.232,0.329,0.485,0.810145751738527,1423,0.253,0.36046511627907,20,80,3337,872,0.325142343422236,0.485003408316292,15.1237113402062
"J Varitek","C",1546,5099,664,1307,306,14,193,757,614,1216,25,18,0.256,0.341,0.435,0.771630142571449,2220,0.179,0.504934210526316,43,58.1395348837209,5713,1421,0.336250656397689,0.43537948617376,26.419689119171
"A Otis","CF",1998,7299,1092,2020,374,66,193,1007,757,1008,341,93,0.277,0.343,0.425,0.770112755716152,3105,0.148,0.750992063492063,434,78.5714285714286,8056,2099,0.344712015888779,0.425400739827374,37.8186528497409
"A Rosen","3B",1044,3725,603,1063,165,20,192,717,587,385,39,33,0.285,0.384,0.495,0.87768661827147,1844,0.21,1.52467532467532,72,54.1666666666667,4312,1320,0.38265306122449,0.49503355704698,19.4010416666667
"J Ram?rez","3B",1141,4163,699,1159,291,33,192,666,475,575,175,42,0.278,0.354,0.503,0.854829248444971,2092,0.225,0.826086956521739,217,80.6451612903226,4638,1365,0.352307028891764,0.502522219553207,21.6822916666667
"J Altuve","2B",1578,6305,986,1935,379,29,192,696,509,840,279,81,0.307,0.362,0.468,0.826238743902499,2948,0.161,0.605952380952381,360,77.5,6814,1682,0.358673319636043,0.467565424266455,32.8385416666667
"C Furillo","RF",1806,6378,895,1910,324,56,192,1058,514,436,48,26,0.299,0.355,0.458,0.809849477136566,2922,0.159,1.17889908256881,74,64.8648648648649,6892,1953,0.351712130005804,0.458137347130762,33.21875
"R Durham","2B",1975,7408,1249,2054,440,79,192,875,820,1201,273,97,0.277,0.352,0.436,0.78504023032557,3228,0.159,0.682764363030808,370,73.7837837837838,8228,2124,0.349295089936801,0.435745140388769,38.5833333333333
"B Dozier","2B",1144,4316,664,1055,231,21,192,561,488,973,105,36,0.244,0.325,0.441,0.762339886671518,1904,0.197,0.501541623843782,141,74.468085106383,4804,1225,0.321190674437968,0.44114921223355,22.4791666666667
"R Martin","C",1693,5701,803,1416,255,9,191,771,792,1211,101,51,0.248,0.349,0.397,0.73683102061824,2262,0.149,0.654004954582989,152,66.4473684210526,6493,1574,0.340058524564916,0.396772496053324,29.848167539267
"H McRae","DH",2084,7218,940,2091,484,66,191,1097,648,779,109,78,0.29,0.351,0.454,0.802626981998348,3280,0.164,0.83183568677792,187,58.2887700534759,7866,2037,0.348207475209764,0.454419506788584,37.7905759162304
"C Young","CF",1465,4710,668,1109,288,24,191,590,520,1192,142,46,0.235,0.314,0.428,0.739922381491721,2018,0.193,0.436241610738255,188,75.531914893617,5230,1258,0.311472275334608,0.428450106157113,24.6596858638743
"G Davis","1B",1015,3719,510,965,177,13,190,603,370,613,28,11,0.259,0.332,0.467,0.79381562072339,1738,0.208,0.603588907014682,39,71.7948717948718,4089,1113,0.326485693323551,0.467329927399839,19.5736842105263
"W Jones","3B",1691,5826,786,1502,252,33,190,812,755,541,40,17,0.258,0.343,0.41,0.753187000849693,2390,0.152,1.39556377079482,57,70.1754385964912,6581,1598,0.342956997416806,0.410230003432887,30.6631578947368
"A Gordon","LF",1753,6391,867,1643,357,26,190,749,684,1535,113,45,0.257,0.338,0.41,0.739169028000396,2622,0.153,0.445602605863192,158,71.5189873417722,7075,1616,0.328904593639576,0.41026443436082,33.6368421052632
"E Lombardi","C",1852,5855,601,1792,277,27,190,990,430,262,8,0,0.306,0.358,0.46,0.813488936761989,2693,0.154,1.6412213740458,8,100,6285,1591,0.353540175019889,0.459948761742101,30.8157894736842
"C Keller","LF",1170,3790,725,1085,166,72,189,760,784,499,45,23,0.286,0.41,0.518,0.926292004942471,1962,0.232,1.57114228456914,68,66.1764705882353,4574,1485,0.408613904678618,0.517678100263852,20.0529100529101
"P Wilson","CF",1108,4003,573,1055,221,16,189,668,350,1085,124,55,0.264,0.329,0.468,0.791164609543072,1875,0.204,0.32258064516129,179,69.2737430167598,4353,1241,0.322765908568803,0.468398700974269,21.1798941798942
"J Snow","1B",1716,5641,798,1509,293,19,189,877,760,1142,20,23,0.268,0.357,0.427,0.781173257225447,2407,0.159,0.665499124343257,43,46.5116279069767,6401,1675,0.354475863146383,0.426697394079064,29.8465608465608
"N Markakis","RF",2154,8302,1119,2388,514,22,189,1046,891,1230,66,32,0.288,0.357,0.423,0.779835481748588,3513,0.135,0.724390243902439,98,67.3469387755102,9193,2165,0.356684433808332,0.423151047940255,43.9259259259259
"B Bailey","3B",1931,6082,772,1564,234,43,189,773,852,1126,85,83,0.257,0.347,0.403,0.751420472464246,2451,0.146,0.756660746003552,168,50.5952380952381,6934,1545,0.348428035765792,0.402992436698454,32.1798941798942
"J Hardy","SS",1561,5805,718,1488,291,14,188,688,411,960,8,9,0.256,0.305,0.408,0.713942929640604,2371,0.152,0.428125,17,47.0588235294118,6216,1406,0.30550193050193,0.408440999138674,30.8776595744681
"D Porter","C",1782,5539,765,1369,237,48,188,826,905,1025,39,37,0.247,0.354,0.409,0.761985521322816,2266,0.162,0.882926829268293,76,51.3157894736842,6444,1591,0.352886405959032,0.409099115363784,29.4627659574468
"B Surhoff","LF",2313,8258,1062,2326,440,42,188,1153,640,839,141,84,0.282,0.332,0.413,0.74675062565593,3414,0.131,0.762812872467223,225,62.6666666666667,8898,2215,0.333333333333333,0.413417292322596,43.9255319148936
"A Pierzynski","C",2059,7290,807,2043,407,24,188,909,308,895,15,23,0.28,0.319,0.42,0.729450967350805,3062,0.14,0.344134078212291,38,39.4736842105263,7598,1716,0.309423532508555,0.42002743484225,38.7765957446809
"B Higginson","LF",1362,4910,736,1336,270,33,187,709,649,796,91,53,0.272,0.358,0.455,0.811864761973849,2233,0.183,0.815326633165829,144,63.1944444444444,5559,1445,0.357078611261018,0.454786150712831,26.2566844919786
"M Stanley","C",1467,4222,625,1138,220,7,187,702,652,929,13,4,0.27,0.37,0.458,0.825094707811652,1933,0.188,0.701829924650161,17,76.4705882352941,4874,1327,0.367254821501847,0.457839886309806,22.5775401069519
"M Semien","2B",1184,4589,686,1171,240,29,187,568,445,1001,107,34,0.255,0.321,0.442,0.763379254237452,2030,0.187,0.444555444555445,141,75.886524822695,5034,1254,0.321017083829956,0.442362170407496,24.5401069518717
"G Hill","RF",1162,3715,528,1005,187,21,186,586,270,845,96,38,0.271,0.321,0.482,0.80231858702976,1792,0.211,0.319526627218935,134,71.6417910447761,3985,1114,0.319949811794228,0.482368775235532,19.9731182795699
"R Aurilia","SS",1652,5721,745,1576,301,22,186,756,450,861,23,18,0.275,0.328,0.433,0.761625690202927,2479,0.158,0.522648083623693,41,56.0975609756098,6171,1501,0.328309836331227,0.433315853871701,30.758064516129
"M Minoso","LF",1835,6579,1136,1963,336,83,186,1023,814,584,205,130,0.298,0.389,0.459,0.835117915837412,3023,0.161,1.39383561643836,335,61.1940298507463,7393,2159,0.375625591776004,0.459492324061407,35.3709677419355
"M Moreland","1B",1260,4071,527,1020,219,9,186,618,385,975,11,5,0.251,0.318,0.446,0.761141610295178,1815,0.195,0.394871794871795,16,68.75,4456,1145,0.315305206463196,0.445836403831982,21.8870967741935
"A Trammell","SS",2293,8288,1231,2365,412,55,185,1003,850,874,236,109,0.285,0.352,0.415,0.767126761176334,3442,0.13,0.97254004576659,345,68.4057971014493,9138,2234,0.351827533377107,0.415299227799228,44.8
"C Chambliss","1B",2175,7571,912,2109,392,42,185,972,632,926,40,35,0.279,0.334,0.415,0.748886501137197,3140,0.136,0.682505399568035,75,53.3333333333333,8203,1884,0.334146044130196,0.414740457007,40.9243243243243
"M Young","SS",1970,7918,1137,2375,441,60,185,1030,575,1235,90,30,0.3,0.346,0.441,0.788239037440964,3491,0.141,0.465587044534413,120,75,8493,2167,0.347344872247733,0.440894165193231,42.8
"B Jordan","RF",1456,5160,755,1454,267,37,184,821,353,842,119,48,0.282,0.333,0.455,0.782615684984188,2347,0.173,0.419239904988124,167,71.2574850299401,5513,1576,0.327770723743878,0.45484496124031,28.0434782608696
"C Gehringer","2B",2323,8860,1775,2839,574,146,184,1427,1186,372,181,89,0.32,0.404,0.48,0.881131018533707,4257,0.16,3.18817204301075,270,67.037037037037,10046,3202,0.400656977901652,0.480474040632054,48.1521739130435
"B Watson","1B",1831,6185,802,1826,307,41,184,989,653,796,27,28,0.295,0.364,0.447,0.809905580186617,2767,0.152,0.82035175879397,55,49.0909090909091,6838,1791,0.362532904357999,0.447372675828618,33.6141304347826
"F Lindor","SS",1068,4236,680,1172,233,23,184,582,406,731,125,37,0.277,0.342,0.473,0.812791428102976,2003,0.196,0.555403556771546,162,77.1604938271605,4642,1262,0.339939681171909,0.472851746931067,23.0217391304348
"H Heilmann","RF",2146,7787,1291,2660,542,151,183,1539,856,550,113,64,0.342,0.41,0.52,0.927286049377769,4053,0.178,1.55636363636364,177,63.8418079096045,8643,2830,0.406803193335647,0.520482856042122,42.551912568306
"T Henrich","RF",1284,4603,901,1297,269,73,183,795,712,383,37,19,0.282,0.382,0.491,0.869188220124754,2261,0.209,1.85900783289817,56,66.0714285714286,5315,1696,0.377986829727187,0.491201390397567,25.1530054644809
"W Davis","CF",2429,9174,1217,2561,395,138,182,1053,418,977,398,131,0.279,0.311,0.412,0.72238731116858,3778,0.133,0.427840327533265,529,75.2362948960302,9592,2270,0.31057130942452,0.411816001744059,50.4065934065934
"S Balboni","1B",960,3120,351,714,127,11,181,495,273,856,1,2,0.229,0.293,0.451,0.741534040671972,1406,0.222,0.31892523364486,3,33.3333333333333,3393,846,0.290893015030946,0.450641025641026,17.2375690607735
"I Desmond","SS",1478,5442,724,1432,277,37,181,711,387,1402,181,56,0.263,0.315,0.427,0.739476778749298,2326,0.164,0.276034236804565,237,76.3713080168776,5829,1435,0.312060387716589,0.427416391032709,30.0662983425414
"B Herman","RF",1553,5603,882,1818,399,110,181,997,520,553,94,0,0.324,0.383,0.532,0.913696901076274,2980,0.208,0.940325497287523,94,100,6123,1879,0.381838967826229,0.531857933250045,30.9558011049724
"N Castellanos","RF",1225,4644,599,1285,308,35,181,658,325,1166,21,18,0.277,0.327,0.475,0.79903038806145,2206,0.198,0.278730703259005,39,53.8461538461538,4969,1257,0.324008854900382,0.475021533161068,25.6574585635359
"S Chapman","CF",1368,4988,754,1329,210,52,180,773,562,682,41,38,0.266,0.342,0.438,0.778371081586799,2183,0.172,0.824046920821114,79,51.8987341772152,5550,1527,0.340720720720721,0.437650360866079,27.7111111111111
"W Held","SS",1390,4019,524,963,150,22,179,559,508,944,14,11,0.24,0.331,0.421,0.746437138414708,1694,0.181,0.538135593220339,25,56,4527,1083,0.324939253368677,0.421497885046031,22.4525139664804
"D Crandall","C",1573,5026,585,1276,179,18,179,657,424,477,26,28,0.254,0.312,0.404,0.715428396193007,2028,0.15,0.888888888888889,54,48.1481481481481,5450,1242,0.311926605504587,0.40350179068842,28.0782122905028
"J Rudi","LF",1547,5556,684,1468,287,39,179,810,369,870,25,15,0.264,0.311,0.427,0.736608068822849,2370,0.163,0.424137931034483,40,62.5,5925,1494,0.310042194092827,0.426565874730022,31.0391061452514
"J Gentile","1B",936,2922,434,759,113,6,179,549,475,663,3,1,0.26,0.368,0.486,0.849572447565664,1421,0.226,0.716440422322775,4,75,3397,983,0.363261701501325,0.486310746064339,16.3240223463687
"J Gallo","OF",755,2374,403,474,90,9,179,390,418,1052,29,8,0.2,0.325,0.471,0.790840601260552,1119,0.271,0.397338403041825,37,78.3783783783784,2792,793,0.319484240687679,0.471356360572873,13.2625698324022
"T Lazzeri","2B",1740,6297,986,1840,334,115,178,1191,869,864,148,79,0.292,0.38,0.467,0.844606549260308,2938,0.175,1.00578703703704,227,65.1982378854625,7166,2177,0.378035166061959,0.466571383198348,35.376404494382
"H Clift","3B",1582,5730,1070,1558,309,62,178,829,1070,713,69,43,0.272,0.39,0.441,0.827133764500565,2525,0.169,1.50070126227209,112,61.6071428571429,6800,1899,0.386470588235294,0.440663176265271,32.1910112359551
"Y Grandal","C",1122,3575,477,848,160,7,178,534,621,994,12,7,0.237,0.351,0.435,0.785340084129407,1556,0.198,0.624748490945674,19,63.1578947368421,4196,1011,0.350095328884652,0.435244755244755,20.0842696629213
"M Olson","1B",740,2675,412,669,146,1,178,479,349,730,7,2,0.25,0.343,0.505,0.841686940612174,1351,0.255,0.478082191780822,9,77.7777777777778,3024,891,0.336640211640212,0.505046728971963,15.0280898876404
"C Cron","1B",982,3427,435,896,184,10,178,574,253,865,10,8,0.261,0.323,0.477,0.78903012839218,1634,0.216,0.292485549132948,18,55.5555555555556,3680,1009,0.312228260869565,0.476801867522615,19.252808988764
"R Kittle","LF",843,2708,356,648,100,3,176,460,236,744,16,16,0.239,0.306,0.473,0.773683851390405,1282,0.234,0.317204301075269,32,50,2944,816,0.300271739130435,0.47341211225997,15.3863636363636
"Y Molina","C",2226,7817,777,2168,408,7,176,1022,542,922,71,37,0.277,0.327,0.399,0.723075707937628,3118,0.122,0.587852494577007,108,65.7407407407407,8359,1799,0.324201459504725,0.398874248432903,44.4147727272727
"D Money","3B",1720,6214,798,1623,302,36,176,729,600,865,80,51,0.261,0.328,0.406,0.732580615327556,2525,0.145,0.69364161849711,131,61.0687022900763,6814,1527,0.326240093924274,0.406340521403283,35.3068181818182
"R Grichuk","RF",1024,3534,471,874,199,24,175,512,207,990,25,16,0.247,0.293,0.466,0.754721348213641,1646,0.219,0.209090909090909,41,60.9756097560976,3741,983,0.288960171077252,0.465761177136389,20.1942857142857
"H Matsui","LF",1236,4442,656,1253,249,12,175,760,547,689,13,9,0.282,0.36,0.462,0.822522697164739,2051,0.18,0.793904208998549,22,59.0909090909091,4989,1416,0.360793746241732,0.461728950923008,25.3828571428571
"B Belt","1B",1312,4397,628,1147,268,36,175,584,618,1209,47,21,0.261,0.356,0.458,0.809528884349907,2012,0.197,0.511166253101737,68,69.1176470588235,5015,1212,0.351944167497507,0.457584716852399,25.1257142857143
"T Story","2B",839,3179,516,853,202,27,174,516,298,987,113,30,0.268,0.336,0.513,0.844086918909803,1631,0.245,0.301925025329281,143,79.020979020979,3477,1032,0.331032499280989,0.513054419628814,18.2701149425287
"C Yelich","LF",1253,4730,798,1355,261,31,174,630,656,1192,157,32,0.286,0.376,0.465,0.838491696819489,2200,0.179,0.550335570469799,189,83.0687830687831,5386,1428,0.373375417749721,0.465116279069767,27.183908045977
"R Odor","2B",1096,3909,521,902,177,29,174,550,253,1008,68,51,0.231,0.287,0.424,0.70191603083558,1659,0.193,0.250992063492063,119,57.1428571428571,4162,1071,0.277510812109563,0.424405218726017,22.4655172413793
"B Buckner","1B",2517,9397,1077,2715,498,49,174,1208,450,453,183,73,0.289,0.321,0.408,0.729313827732229,3833,0.119,0.993377483443709,256,71.484375,9847,2285,0.321417690667208,0.407896137065021,54.0057471264368
"J Schoop","3B",1135,4187,542,1066,210,7,174,537,183,996,15,4,0.255,0.294,0.433,0.718580448691848,1812,0.178,0.183734939759036,19,78.9473684210526,4370,1079,0.285812356979405,0.432768091712443,24.0632183908046
"J Franco","SS",2527,8677,1285,2586,407,54,173,1194,917,1341,281,107,0.298,0.365,0.417,0.78231891887983,3620,0.119,0.683818046234154,388,72.4226804123711,9594,2479,0.365124035855743,0.417194883024087,50.1560693641619
"W Cooper","C",1473,4702,573,1341,240,40,173,812,309,357,18,1,0.285,0.332,0.464,0.792908090503742,2180,0.179,0.865546218487395,19,94.7368421052632,5011,1385,0.329275593693873,0.463632496809868,27.1791907514451
"K Calhoun","RF",1196,4291,618,1042,198,18,173,557,437,1089,34,16,0.243,0.316,0.418,0.731134667412729,1795,0.175,0.401285583103765,50,68,4728,1175,0.312817258883249,0.41831740852948,24.8034682080925
"M Grace","1B",2245,8065,1179,2445,511,45,173,1146,1075,642,70,48,0.303,0.383,0.442,0.82715382810073,3565,0.139,1.67445482866044,118,59.3220338983051,9140,2325,0.385120350109409,0.442033477991321,46.6184971098266
"N Colbert","1B",1004,3422,481,833,141,25,173,520,383,902,52,31,0.243,0.322,0.451,0.770485403637743,1543,0.208,0.424611973392461,83,62.6506024096386,3805,1001,0.31957950065703,0.450905902980713,19.7803468208092
"J Pederson","1B",1023,2976,460,705,150,13,173,436,387,831,22,23,0.237,0.334,0.47,0.795140187812341,1400,0.233,0.465703971119134,45,48.8888888888889,3363,896,0.324710080285459,0.470430107526882,17.2023121387283
"E Robinson","1B",1315,4282,546,1146,172,24,172,723,521,359,10,12,0.268,0.353,0.44,0.786588990630661,1882,0.172,1.45125348189415,22,45.4545454545455,4803,1269,0.347074744951072,0.439514245679589,24.8953488372093
"M Vernon","1B",2409,8731,1196,2495,490,120,172,1311,955,869,137,90,0.286,0.359,0.428,0.784657439570915,3741,0.142,1.09896432681243,227,60.352422907489,9686,2507,0.356184183357423,0.428473256213492,50.7616279069767
"K Bryant","RF",930,3463,623,969,217,19,172,502,462,938,44,20,0.28,0.377,0.502,0.86704050646415,1740,0.222,0.492537313432836,64,68.75,3925,1125,0.364585987261146,0.502454519203003,20.1337209302326
"M Mora","3B",1556,5422,794,1503,283,19,171,754,520,953,93,55,0.277,0.35,0.431,0.771479521517544,2337,0.154,0.545645330535152,148,62.8378378378378,5942,1548,0.340457758330528,0.431021763187016,31.7076023391813
"R Hidalgo","CF",987,3459,531,929,214,19,171,560,358,737,48,34,0.269,0.345,0.49,0.826912710691651,1694,0.221,0.485753052917232,82,58.5365853658537,3817,1091,0.337175792507205,0.489736918184446,20.2280701754386
"D Young","1B",1364,4762,648,1389,301,29,171,683,407,871,25,22,0.292,0.351,0.475,0.822256491608415,2261,0.183,0.467278989667049,47,53.1914893617021,5169,1331,0.347455987618495,0.47480050398992,27.8479532163743
"J Cronin","SS",2124,7579,1232,2285,515,118,170,1424,1059,700,87,71,0.301,0.39,0.468,0.854998400578046,3546,0.167,1.51285714285714,158,55.0632911392405,8638,2656,0.387126649687428,0.467871750890619,44.5823529411765
"T Raines","LF",2502,8872,1571,2605,430,113,170,980,1330,966,808,146,0.294,0.385,0.425,0.810753770234412,3771,0.131,1.3768115942029,954,84.6960167714885,10202,2551,0.385708684571653,0.425045085662759,52.1882352941176
"K Millar","1B",1427,4688,648,1284,296,15,170,699,564,838,7,9,0.274,0.358,0.452,0.804084385860482,2120,0.178,0.673031026252983,16,43.75,5252,1347,0.351865955826352,0.45221843003413,27.5764705882353
"M Carpenter","1B",1379,4538,780,1194,311,28,170,616,719,1108,27,17,0.263,0.369,0.456,0.820264202285471,2071,0.193,0.648916967509025,44,61.3636363636364,5257,1396,0.363895758036903,0.456368444248568,26.6941176470588
"B Elliott","3B",1978,7141,1064,2061,382,94,170,1195,967,604,60,2,0.289,0.375,0.44,0.813312674911659,3141,0.151,1.60099337748344,62,96.7741935483871,8108,2259,0.373458312777504,0.439854362134155,42.0058823529412
"J Hart","3B",1125,3783,518,1052,148,29,170,578,380,573,17,17,0.278,0.345,0.467,0.811336656670241,1768,0.189,0.663176265270506,34,50,4163,1096,0.343982704780207,0.467353951890034,22.2529411764706
"E Slaughter","RF",2380,7946,1247,2383,413,148,169,1304,1018,538,71,15,0.3,0.382,0.453,0.832338807926282,3599,0.153,1.89219330855019,86,82.5581395348837,8964,2551,0.379406514948684,0.452932292977599,47.0177514792899
"R Hernandez","C",1526,5105,580,1345,262,8,169,757,430,734,9,5,0.263,0.327,0.417,0.737924542157599,2130,0.154,0.5858310626703,14,64.2857142857143,5535,1337,0.320686540198735,0.417238001958864,30.207100591716
"L Moseby","CF",1587,5815,869,1494,273,66,169,737,616,1135,280,93,0.257,0.332,0.414,0.741855797631127,2406,0.157,0.54273127753304,373,75.0670241286863,6431,1606,0.328098273985383,0.413757523645744,34.4082840236686
"T Wigginton","3B",1362,4479,558,1170,245,14,169,594,371,891,42,23,0.261,0.323,0.435,0.753096995601467,1950,0.174,0.41638608305275,65,64.6153846153846,4850,1152,0.317731958762887,0.43536503683858,26.5029585798817
"P O'Brien","1B",1567,5437,654,1421,254,21,169,736,641,563,24,34,0.261,0.336,0.409,0.748305442284451,2224,0.148,1.13854351687389,58,41.3793103448276,6078,1390,0.3392563343205,0.409049107963951,32.1715976331361
"A Rios","RF",1691,6419,885,1778,374,63,169,794,400,1117,253,77,0.277,0.321,0.434,0.753269875569442,2785,0.157,0.35810205908684,330,76.6666666666667,6819,1679,0.319401671799384,0.433868203770058,37.9822485207101
"J Hernandez","SS",1587,4618,623,1166,193,33,168,603,384,1391,41,38,0.252,0.312,0.418,0.727589345379215,1929,0.166,0.276060388209921,79,51.8987341772152,5002,1226,0.309876049580168,0.417713295799047,27.4880952380952
"G Triandos","C",1206,3907,389,954,147,6,167,608,440,636,1,0,0.244,0.322,0.413,0.733785613277273,1614,0.169,0.691823899371069,1,100,4347,997,0.320680929376582,0.413104683900691,23.3952095808383
"B Zobrist","2B",1651,5880,884,1566,349,44,167,768,832,994,116,49,0.266,0.357,0.426,0.783120900326758,2504,0.16,0.837022132796781,165,70.3030303030303,6712,1652,0.357270560190703,0.425850340136054,35.2095808383234
"C Blake","3B",1265,4500,644,1186,264,18,167,616,445,1037,36,37,0.264,0.336,0.442,0.771383664756769,1987,0.178,0.429122468659595,73,49.3150684931507,4945,1260,0.329828109201213,0.441555555555556,26.9461077844311
"C Johnson","C",1188,3836,465,940,211,4,167,570,475,997,6,10,0.245,0.33,0.433,0.760972549065139,1660,0.188,0.476429287863591,16,37.5,4311,1035,0.328230109023428,0.43274244004171,22.9700598802395
"E Howard","C",1605,5363,619,1471,218,50,167,762,373,786,9,14,0.274,0.322,0.427,0.748478195685037,2290,0.153,0.474554707379135,23,39.1304347826087,5736,1381,0.321478382147838,0.426999813537199,32.1137724550898
"D Murphy","CF",1360,4347,648,1069,139,20,166,609,747,953,100,61,0.246,0.356,0.402,0.758154155296573,1746,0.156,0.783840503672613,161,62.111801242236,5094,1257,0.356497840596781,0.401656314699793,26.1867469879518
"P Sorrento","1B",1093,3412,454,876,176,5,166,565,426,844,8,15,0.257,0.34,0.457,0.79644903467332,1560,0.2,0.504739336492891,23,34.7826086956522,3838,1019,0.339239187076602,0.457209847596717,20.5542168674699
"B Robinson","LF",1472,4364,536,1127,229,29,166,641,263,820,71,49,0.258,0.3,0.438,0.738540789060028,1912,0.18,0.320731707317073,120,59.1666666666667,4627,1177,0.30041063323968,0.438130155820348,26.289156626506
"T Conigliaro","RF",876,3221,464,849,139,23,166,516,287,629,20,23,0.264,0.327,0.476,0.79945992961668,1532,0.212,0.456279809220986,43,46.5116279069767,3508,980,0.323831242873432,0.475628686743247,19.4036144578313
"J B?ez","SS",1009,3605,515,937,187,23,166,532,183,1103,90,32,0.26,0.302,0.463,0.758361245893668,1668,0.203,0.165911151405258,122,73.7704918032787,3788,1047,0.295670538542767,0.462690707350902,21.7168674698795
"C Rasmus","CF",1092,3704,536,891,183,21,166,491,362,1106,35,17,0.241,0.31,0.436,0.743910413384342,1614,0.195,0.327305605786618,52,67.3076923076923,4066,1027,0.308165272995573,0.435745140388769,22.3132530120482
"L Hisle","CF",1197,4205,652,1146,193,32,166,674,462,941,128,61,0.273,0.347,0.452,0.796627674208085,1901,0.179,0.490967056323061,189,67.7248677248677,4667,1326,0.344546818084423,0.452080856123662,25.3313253012048
"Y Cespedes","LF",834,3191,475,870,173,24,165,528,240,742,43,20,0.273,0.327,0.497,0.820543716246537,1586,0.224,0.323450134770889,63,68.2539682539683,3431,1003,0.323520839405421,0.497022876841116,19.3393939393939
"J Cruz","LF",2353,7917,1036,2251,391,94,165,1077,898,1031,317,136,0.284,0.354,0.42,0.777214307458601,3325,0.136,0.870999030067895,453,69.9779249448124,8815,2113,0.35723199092456,0.419982316534041,47.9818181818182
"J Jones","LF",1302,4594,632,1272,255,19,165,630,314,949,82,45,0.277,0.326,0.448,0.771556855102098,2060,0.171,0.330874604847208,127,64.5669291338583,4908,1262,0.323145884270579,0.448410970831519,27.8424242424242
"A Duvall","CF",833,2784,388,645,140,14,165,486,204,868,18,12,0.232,0.291,0.47,0.753964132391636,1308,0.238,0.235023041474654,30,60,2988,874,0.284136546184739,0.469827586206897,16.8727272727273
"A Van Slyke","CF",1658,5711,835,1562,293,91,164,792,667,1063,245,59,0.274,0.349,0.443,0.792312223460757,2529,0.169,0.627469426152399,304,80.5921052631579,6378,1627,0.349482596425212,0.442829627035545,34.8231707317073
"C Hafey","LF",1283,4625,777,1466,341,67,164,833,372,477,70,7,0.317,0.372,0.526,0.893874746469503,2433,0.209,0.779874213836478,77,90.9090909090909,4997,1610,0.367820692415449,0.526054054054054,28.2012195121951
"J Turner","1B",1396,4534,656,1312,293,9,164,664,464,771,41,10,0.289,0.366,0.466,0.821817655160873,2115,0.177,0.601815823605707,51,80.3921568627451,4998,1320,0.355342136854742,0.466475518306131,27.6463414634146
"J Lemon","RF",1010,3445,446,901,121,35,164,529,363,787,13,18,0.262,0.332,0.46,0.791729580075862,1584,0.198,0.461245235069886,31,41.9354838709677,3808,975,0.331932773109244,0.459796806966618,21.0060975609756
"C Washington","RF",1912,6787,926,1884,334,69,164,824,468,1266,312,134,0.278,0.325,0.42,0.743815968765844,2848,0.142,0.369668246445498,446,69.9551569506726,7255,1750,0.324190213645762,0.419625755120082,41.3841463414634
"H Bauer","RF",1544,5145,833,1424,229,57,164,703,521,638,50,33,0.277,0.346,0.439,0.782342734885291,2259,0.162,0.816614420062696,83,60.2409638554217,5666,1536,0.343275679491705,0.439067055393586,31.3719512195122
"B Upton","CF",1469,5175,723,1260,262,32,164,586,589,1561,300,92,0.243,0.321,0.402,0.722330071374213,2078,0.159,0.377322229340167,392,76.530612244898,5764,1309,0.320784177654407,0.401545893719807,31.5548780487805
"A Smith","RF",1518,5357,843,1458,258,46,164,676,674,768,67,43,0.272,0.358,0.429,0.782851663641777,2300,0.157,0.877604166666667,110,60.9090909090909,6031,1519,0.353506881114243,0.429344782527534,32.6646341463415
"A Seminick","C",1304,3921,495,953,139,26,164,556,582,780,23,7,0.243,0.347,0.417,0.758124355080121,1636,0.174,0.746153846153846,30,76.6666666666667,4503,1051,0.340883855207639,0.417240499872482,23.9085365853659
"R Smalley","SS",1653,5657,745,1454,244,25,163,694,770,908,27,34,0.257,0.345,0.395,0.741479421915768,2237,0.138,0.848017621145374,61,44.2622950819672,6427,1439,0.346040143146102,0.395439278769666,34.7055214723926
"B Madlock","3B",1806,6594,920,2008,348,34,163,860,605,510,174,90,0.305,0.365,0.442,0.804732319889238,2913,0.137,1.18627450980392,264,65.9090909090909,7199,1780,0.362967078760939,0.441765241128298,40.4539877300613
"D Demeter","CF",1109,3443,467,912,147,17,163,563,180,658,22,25,0.265,0.307,0.459,0.760890682202782,1582,0.194,0.273556231003039,47,46.8085106382979,3623,1030,0.301407673199006,0.459483009003776,21.1226993865031
"K Keltner","3B",1526,5683,737,1570,308,69,163,852,514,480,39,33,0.276,0.338,0.441,0.777080070104818,2505,0.165,1.07083333333333,72,54.1666666666667,6197,1589,0.336291754074552,0.440788316030266,34.8650306748466
"D Easley","2B",1706,5484,735,1386,287,27,163,684,510,935,114,56,0.253,0.329,0.404,0.720400926090204,2216,0.151,0.545454545454545,170,67.0588235294118,5994,1419,0.316316316316316,0.404084609773888,33.6441717791411
"A Hill","2B",1559,5646,736,1501,325,22,162,695,443,847,74,35,0.266,0.323,0.417,0.736550821568856,2356,0.151,0.523022432113341,109,67.8899082568807,6089,1431,0.319264247002792,0.417286574566064,34.8518518518519
"J Gomes","LF",1203,3456,495,835,157,14,162,526,417,1088,50,24,0.242,0.333,0.436,0.759027508821758,1506,0.194,0.383272058823529,74,67.5675675675676,3873,1021,0.323263619932869,0.435763888888889,21.3333333333333
"A Ethier","RF",1455,4800,641,1367,303,34,162,687,519,938,29,28,0.285,0.359,0.463,0.817911261515322,2224,0.178,0.553304904051173,57,50.8771929824561,5319,1328,0.354577928181989,0.463333333333333,29.6296296296296
"T Steinbach","C",1546,5369,638,1453,273,21,162,745,418,938,23,22,0.271,0.326,0.42,0.743128339854491,2254,0.149,0.445628997867804,45,51.1111111111111,5787,1383,0.323310869189563,0.419817470664928,33.141975308642
"K Hernandez","1B",2088,7370,1124,2182,426,60,162,1071,1070,1012,98,63,0.296,0.384,0.436,0.82140032281505,3214,0.14,1.05731225296443,161,60.8695652173913,8440,2195,0.385308056872038,0.436092265943012,45.4938271604938
"P ?lvarez","3B",910,2980,365,704,131,6,162,472,314,952,15,3,0.236,0.31,0.447,0.756362187911313,1333,0.211,0.329831932773109,18,83.3333333333333,3294,837,0.309046751669702,0.447315436241611,18.3950617283951
"M San?","1B",694,2502,386,585,123,6,162,418,333,1042,5,3,0.234,0.326,0.482,0.805823912298733,1206,0.248,0.31957773512476,8,62.5,2835,804,0.323809523809524,0.482014388489209,15.4444444444444
"C Boyer","3B",1725,5780,645,1396,200,33,162,654,470,931,41,28,0.242,0.299,0.372,0.670186297577855,2148,0.13,0.504833512352309,69,59.4202898550725,6250,1299,0.29856,0.371626297577855,35.679012345679
"C Hart","RF",1048,3729,549,1009,221,33,162,538,286,853,85,40,0.271,0.329,0.478,0.800416579420095,1782,0.207,0.335287221570926,125,68,4015,1087,0.322540473225405,0.47787610619469,23.0185185185185
"J Samuel","2B",1720,6081,873,1578,287,102,161,703,440,1442,396,143,0.259,0.315,0.42,0.729129556790213,2552,0.161,0.305131761442441,539,73.469387755102,6521,1576,0.309461738997086,0.419667817793126,37.7701863354037
"R Weeks Jr.","2B",1324,4417,733,1087,219,33,161,474,533,1230,132,32,0.246,0.344,0.42,0.74724103155165,1855,0.174,0.433333333333333,164,80.4878048780488,4950,1207,0.327272727272727,0.419968304278922,27.4347826086957
"T Phillips","2B",2161,7617,1300,2023,360,50,160,819,1319,1499,177,114,0.266,0.374,0.389,0.76299113125014,2963,0.123,0.879919946631087,291,60.8247422680412,8936,2119,0.373992837958818,0.388998293291322,47.60625
"B Melton","3B",1144,3971,496,1004,162,9,160,591,480,669,23,24,0.253,0.337,0.419,0.75244624855749,1664,0.166,0.717488789237668,47,48.936170212766,4451,1087,0.333408222871265,0.419038025686225,24.81875
"F White","2B",2324,7859,912,2006,407,58,160,886,412,1035,178,83,0.255,0.293,0.383,0.675219892794028,3009,0.128,0.398067632850242,261,68.1992337164751,8271,1798,0.292346753717809,0.382873139076218,49.11875
"P Rose","1B",3562,14053,2165,4256,746,135,160,1314,1566,1143,198,149,0.303,0.375,0.409,0.782058757584901,5752,0.106,1.37007874015748,347,57.0605187319885,15619,3479,0.372751136436392,0.409307621148509,87.83125
"H Rodriguez","LF",950,3031,389,784,176,9,160,523,276,803,10,14,0.259,0.321,0.481,0.801561567661331,1458,0.222,0.343711083437111,24,41.6666666666667,3307,912,0.320532204414878,0.481029363246453,18.94375
"A Davis","1B",1206,4240,568,1189,220,10,160,683,685,558,7,16,0.28,0.38,0.45,0.830743463269802,1909,0.17,1.22759856630824,23,30.4347826086957,4925,1251,0.380507614213198,0.450235849056604,26.5
"J Francoeur","RF",1481,5260,626,1373,281,27,160,698,284,1080,54,39,0.261,0.303,0.416,0.714851255630723,2188,0.155,0.262962962962963,93,58.0645161290323,5544,1324,0.298881673881674,0.415969581749049,32.875
"R White","LF",1881,6650,964,1803,300,51,160,758,934,709,233,118,0.271,0.36,0.404,0.764650748707211,2685,0.133,1.31734837799718,351,66.3817663817664,7584,1722,0.36089135021097,0.403759398496241,41.5625
"B Moss","1B",1016,3133,419,742,159,17,160,473,328,968,11,11,0.237,0.314,0.452,0.760802994435372,1415,0.215,0.338842975206612,22,50,3461,892,0.309159202542618,0.451643791892755,19.58125
"J Heyward","CF",1581,5530,781,1422,269,39,159,641,644,1101,118,40,0.257,0.339,0.406,0.74077737182878,2246,0.149,0.584922797456857,158,74.6835443037975,6174,1422,0.334629089731131,0.406148282097649,34.7798742138365
"J Hickman","RF",1421,3974,518,1002,163,25,159,560,491,832,17,19,0.252,0.335,0.426,0.760145988116486,1692,0.174,0.590144230769231,36,47.2222222222222,4465,1078,0.33437849944009,0.425767488676397,24.9937106918239
"M Byrd","CF",1573,5579,740,1534,311,39,159,710,382,1234,56,31,0.275,0.329,0.43,0.751607201003812,2400,0.155,0.309562398703404,87,64.367816091954,5961,1450,0.321422580104009,0.430184620899803,35.0880503144654
"D Clendenon","1B",1362,4648,594,1273,192,57,159,682,379,1140,90,57,0.274,0.328,0.442,0.770966214455709,2056,0.168,0.332456140350877,147,61.2244897959184,5027,1276,0.328625422717326,0.442340791738382,29.2327044025157
"C Carter","1B",750,2469,334,536,107,5,158,400,327,951,12,5,0.217,0.312,0.456,0.765115327051142,1127,0.239,0.34384858044164,17,70.5882352941177,2796,734,0.30865522174535,0.456460105305792,15.626582278481
"B Posey","C",1371,4970,663,1500,293,9,158,729,540,721,23,9,0.302,0.372,0.46,0.829994485972094,2285,0.158,0.748959778085992,32,71.875,5510,1392,0.370235934664247,0.459758551307847,31.4556962025316
"E Escobar","3B",1269,4419,562,1121,241,41,158,605,334,972,21,17,0.254,0.307,0.434,0.740157298493056,1918,0.18,0.343621399176955,38,55.2631578947368,4753,1167,0.306122448979592,0.434034849513465,27.9683544303797
"X Bogaerts","SS",1268,4848,755,1416,310,15,158,688,463,989,74,17,0.292,0.356,0.46,0.813777510776873,2230,0.168,0.468149646107179,91,81.3186813186813,5311,1443,0.353794012427038,0.459983498349835,30.6835443037975
"H Renfroe","RF",704,2453,347,587,131,4,157,394,202,698,14,4,0.239,0.299,0.488,0.785149050741511,1197,0.249,0.289398280802292,18,77.7777777777778,2655,741,0.297175141242938,0.487973909498573,15.6242038216561
"A Gonzalez","SS",1609,5776,667,1418,332,31,157,690,300,1168,30,22,0.245,0.29,0.395,0.678008043088561,2283,0.15,0.256849315068493,52,57.6923076923077,6076,1357,0.28275181040158,0.395256232686981,36.7898089171975
"K McMullen","3B",1583,5131,568,1273,172,26,156,606,510,815,20,19,0.248,0.316,0.383,0.69904499282424,1965,0.135,0.625766871165644,39,51.2820512820513,5641,1174,0.316078709448679,0.38296628337556,32.8910256410256
"J Encarnacion","RF",1259,4685,618,1264,242,46,156,667,288,853,127,59,0.27,0.317,0.441,0.753067117396588,2066,0.171,0.337631887456038,186,68.2795698924731,4973,1285,0.312085260406193,0.440981856990395,30.0320512820513
"L Duda","1B",958,3098,387,741,171,4,156,470,394,879,6,7,0.239,0.334,0.448,0.773059624618329,1388,0.209,0.448236632536974,13,46.1538461538462,3492,857,0.325028636884307,0.448030987734022,19.8589743589744
"A Rendon","3B",1075,4002,639,1138,279,16,156,636,500,719,47,16,0.284,0.367,0.479,0.842848788844138,1917,0.195,0.695410292072323,63,74.6031746031746,4502,1275,0.363838294091515,0.479010494752624,25.6538461538462
"B Meusel","LF",1407,5475,826,1693,368,95,156,1067,375,619,142,102,0.309,0.356,0.497,0.850125278070484,2719,0.188,0.605815831987076,244,58.1967213114754,5850,1893,0.353504273504273,0.49662100456621,35.0961538461538
"D Rader","3B",1465,5186,631,1302,245,39,155,722,528,1055,37,33,0.251,0.322,0.403,0.723274112028008,2090,0.152,0.500473933649289,70,52.8571428571429,5714,1353,0.320266013300665,0.403008098727343,33.458064516129
"E Bailey","C",1212,3581,432,915,128,15,155,540,545,577,17,18,0.256,0.355,0.429,0.783342580807334,1538,0.173,0.944540727902946,35,48.5714285714286,4126,972,0.353853611245759,0.429488969561575,23.1032258064516
"K Johnson","2B",1399,4543,632,1140,230,40,155,550,516,1145,87,36,0.251,0.33,0.422,0.748865043379602,1915,0.171,0.450655021834061,123,70.7317073170732,5059,1182,0.327337418462147,0.421527624917455,29.3096774193548
"D Lopes","2B",1811,6354,1023,1671,232,50,155,614,833,852,557,114,0.263,0.349,0.388,0.736823591050869,2468,0.125,0.977699530516432,671,83.0104321907601,7187,1637,0.348406845693613,0.388416745357255,40.9935483870968
"S Lollar","C",1752,5351,623,1415,244,14,155,808,671,453,20,10,0.264,0.357,0.402,0.748564365097241,2152,0.138,1.48123620309051,30,66.6666666666667,6022,1431,0.346396545998007,0.402167819099234,34.5225806451613
"C Correa","SS",891,3359,509,935,186,9,155,553,409,785,33,9,0.278,0.357,0.478,0.834210970432131,1604,0.2,0.521019108280255,42,78.5714285714286,3768,1062,0.356687898089172,0.477523072342959,21.6709677419355
"G Sanchez","C",666,2351,341,530,102,2,154,401,260,718,6,2,0.225,0.311,0.467,0.769601370767037,1098,0.242,0.362116991643454,8,75,2611,742,0.302566066641134,0.467035304125904,15.2662337662338
"C Quentin","LF",834,2790,416,702,173,6,154,491,298,516,16,9,0.252,0.347,0.484,0.807346741694059,1349,0.232,0.577519379844961,25,64,3088,907,0.323834196891192,0.483512544802867,18.1168831168831
"R Ludwick","RF",1065,3549,454,923,201,8,154,587,339,888,17,20,0.26,0.33,0.451,0.775983236453322,1602,0.191,0.381756756756757,37,45.945945945946,3888,1041,0.324588477366255,0.451394759087067,23.0454545454545
"J King","3B",1200,4262,600,1091,222,18,154,709,442,584,75,32,0.256,0.324,0.425,0.750810736072937,1811,0.169,0.756849315068493,107,70.0934579439252,4704,1309,0.325892857142857,0.42491787893008,27.6753246753247
"B Terry","1B",1720,6428,1120,2193,373,112,154,1078,537,449,56,6,0.341,0.393,0.506,0.897871435584894,3252,0.165,1.19599109131403,62,90.3225806451613,6965,2198,0.391959798994975,0.505911636589919,41.7402597402597
"P Sandoval","1B",1380,4609,548,1279,262,21,153,639,357,757,12,13,0.278,0.33,0.443,0.772486407243808,2042,0.165,0.471598414795244,25,48,4966,1187,0.329440193314539,0.443046213929269,30.1241830065359
"T Tresh","LF",1192,4251,595,1041,179,34,153,530,550,698,45,25,0.245,0.335,0.411,0.742351420455562,1747,0.166,0.787965616045845,70,64.2857142857143,4801,1125,0.331389293897105,0.410962126558457,27.7843137254902
"J Northrup","RF",1392,4692,603,1254,218,42,153,610,449,635,39,38,0.267,0.333,0.429,0.760712900469339,2015,0.162,0.707086614173228,77,50.6493506493506,5141,1213,0.331258510017506,0.429454390451833,30.6666666666667
"H Blalock","3B",936,3567,507,959,198,17,153,542,313,720,14,7,0.269,0.329,0.463,0.790408642799546,1650,0.194,0.434722222222222,21,66.6666666666667,3880,1049,0.327835051546392,0.462573591253154,23.3137254901961
"D Driessen","1B",1732,5479,746,1464,282,23,153,763,761,719,154,63,0.267,0.356,0.411,0.767411907235552,2251,0.144,1.05841446453408,217,70.9677419354839,6240,1509,0.356570512820513,0.410841394415039,35.8104575163399
"W Myers","RF",1066,3709,523,942,208,14,153,521,408,1126,105,32,0.254,0.328,0.441,0.769267528197369,1637,0.187,0.36234458259325,137,76.6423357664234,4117,1044,0.327908671362643,0.441358856834726,24.2418300653595
"T Davis","LF",1999,7223,811,2121,272,35,153,1052,381,754,136,59,0.294,0.329,0.405,0.733578398189255,2922,0.111,0.505305039787798,195,69.7435897435897,7604,1863,0.329037348763809,0.404541049425446,47.2091503267974
"K Griffey","RF",2097,7229,1129,2143,364,77,152,859,719,898,200,83,0.296,0.359,0.431,0.7912705583944,3117,0.135,0.800668151447661,283,70.6713780918728,7948,1988,0.360090588827378,0.431179969567022,47.5592105263158
"W Dropo","1B",1288,4124,478,1113,168,22,152,704,328,582,5,6,0.27,0.326,0.432,0.755537022561161,1781,0.162,0.563573883161512,11,45.4545454545455,4452,1182,0.323674752920036,0.431862269641125,27.1315789473684
"E Sprague","3B",1203,4095,506,1010,225,12,152,558,358,833,6,12,0.247,0.318,0.419,0.726012042203374,1715,0.172,0.429771908763505,18,33.3333333333333,4453,1064,0.307208623399955,0.418803418803419,26.9407894736842
"C Bellinger","CF",748,2638,434,652,134,19,152,423,328,695,62,14,0.247,0.331,0.485,0.815627401170813,1280,0.238,0.471942446043165,76,81.5789473684211,2966,857,0.330411328388402,0.485216072782411,17.3552631578947
"B Inge","3B",1532,5014,563,1166,228,38,152,648,443,1306,45,40,0.233,0.301,0.384,0.67897510207629,1926,0.151,0.339203675344564,85,52.9411764705882,5457,1211,0.29485065054059,0.3841244515357,32.9868421052632
"C Lansford","3B",1862,7158,1007,2074,332,40,151,874,553,719,224,104,0.29,0.343,0.411,0.751271692547657,2939,0.121,0.769123783031989,328,68.2926829268293,7711,1881,0.340682142393983,0.410589550153674,47.4039735099338
"C Hoiles","C",894,2820,415,739,122,2,151,449,435,616,5,7,0.262,0.366,0.467,0.828051769781351,1318,0.205,0.706168831168831,12,41.6666666666667,3255,864,0.360675883256528,0.467375886524823,18.6754966887417
"J Fregosi","SS",1902,6523,844,1726,264,78,151,706,715,1097,76,40,0.265,0.338,0.398,0.73568416083934,2599,0.133,0.651777575205105,116,65.5172413793103,7238,1550,0.337247858524454,0.398436302314886,43.1986754966887
"R Boone","3B",1373,4589,645,1260,162,46,151,737,608,463,21,19,0.275,0.361,0.429,0.788071826643873,1967,0.154,1.31317494600432,40,52.5,5197,1382,0.359438137386954,0.428633689256919,30.3907284768212
"L Overbay","1B",1587,5102,645,1355,356,12,151,675,638,1108,19,7,0.266,0.347,0.429,0.776063974365453,2188,0.163,0.575812274368231,26,73.0769230769231,5740,1320,0.347212543554007,0.428851430811446,33.7880794701987
"M Lieberthal","C",1212,4218,534,1155,257,10,150,610,335,571,8,7,0.274,0.337,0.446,0.773439778919104,1882,0.172,0.586690017513135,15,53.3333333333333,4553,1144,0.327256753788711,0.446183025130394,28.12
"G Sizemore","CF",1101,4147,660,1098,252,47,150,518,483,952,143,47,0.265,0.349,0.457,0.798184380600408,1894,0.192,0.507352941176471,190,75.2631578947368,4630,1178,0.3414686825054,0.456715698095008,27.6466666666667
"S Dunston","SS",1814,5927,736,1597,292,62,150,668,203,1000,212,82,0.269,0.296,0.416,0.70919377714339,2463,0.147,0.203,294,72.108843537415,6130,1404,0.293637846655791,0.415555930487599,39.5133333333333
"K Youkilis","1B",1061,3749,653,1053,254,18,150,618,539,828,26,14,0.281,0.382,0.478,0.849529526281635,1793,0.197,0.650966183574879,40,65,4288,1271,0.371268656716418,0.478260869565217,24.9933333333333
"M Joyce","LF",1400,3718,537,898,206,15,149,503,559,935,35,23,0.242,0.342,0.425,0.765887958195651,1581,0.183,0.597860962566845,58,60.3448275862069,4277,1040,0.340659340659341,0.42522861753631,24.9530201342282
"C Snyder","RF",1068,3656,439,902,178,13,149,488,226,992,28,19,0.247,0.291,0.425,0.715353051789271,1553,0.178,0.227822580645161,47,59.5744680851064,3882,927,0.290571870170015,0.424781181619256,24.5369127516779
"H Brooks","OF",1645,5974,656,1608,290,31,149,824,387,1005,64,56,0.269,0.315,0.403,0.716542553759789,2407,0.134,0.385074626865672,120,53.3333333333333,6361,1480,0.313629932400566,0.402912621359223,40.0939597315436
"L Brock","LF",2616,10332,1610,3023,486,141,149,900,761,1730,938,307,0.293,0.343,0.41,0.751297978073598,4238,0.117,0.439884393063584,1245,75.3413654618474,11093,2510,0.341116019111151,0.410181958962447,69.3422818791946
"N Walker","2B",1306,4583,611,1224,238,22,149,609,460,931,32,22,0.267,0.338,0.426,0.760068300246075,1953,0.159,0.494092373791622,54,59.2592592592593,5043,1220,0.333928217330954,0.426140082915121,30.758389261745
"E Torgeson","1B",1668,4969,848,1318,215,46,149,740,980,653,133,39,0.265,0.385,0.417,0.803268717891573,2072,0.152,1.50076569678407,172,77.3255813953488,5949,1588,0.386283408976299,0.416985308915275,33.3489932885906
"W Kirkland","RF",1149,3494,443,837,134,29,148,509,323,648,52,19,0.24,0.304,0.422,0.725483440379623,1473,0.182,0.498456790123457,71,73.2394366197183,3817,952,0.303903589206183,0.42157985117344,23.6081081081081
"S Lezcano","RF",1291,4134,560,1122,184,34,148,591,576,768,37,31,0.271,0.36,0.44,0.800277333530548,1818,0.169,0.75,68,54.4117647058823,4710,1151,0.360509554140127,0.439767779390421,27.9324324324324
"G Kelly","1B",1623,5993,819,1778,337,76,148,1020,386,694,65,43,0.297,0.342,0.452,0.791599213033903,2711,0.155,0.556195965417867,108,60.1851851851852,6379,1839,0.339238125097978,0.452361087935925,40.4932432432432
"C Maxwell","LF",1133,3245,478,856,110,26,148,532,484,545,18,7,0.264,0.36,0.451,0.80988496029744,1462,0.187,0.888073394495413,25,72,3729,1010,0.359345669080182,0.450539291217257,21.9256756756757
"R Hoskins","1B",667,2427,392,588,149,7,148,405,388,689,15,8,0.242,0.353,0.492,0.839091452655553,1195,0.25,0.563134978229318,23,65.2173913043478,2815,797,0.346714031971581,0.492377420683972,16.3986486486486
"M Marshall","RF",1035,3593,433,971,173,8,148,530,247,810,26,33,0.27,0.321,0.446,0.763611101447259,1604,0.176,0.304938271604938,59,44.0677966101695,3840,963,0.3171875,0.446423601447259,24.277027027027
"R Jones","CF",1331,4415,643,1103,215,38,147,579,534,817,143,84,0.25,0.33,0.416,0.74640243278725,1835,0.166,0.653610771113831,227,62.9955947136564,4949,1222,0.330773893715902,0.415628539071348,30.0340136054422
"G Woodling","LF",1797,5587,830,1585,257,63,147,830,921,477,29,45,0.284,0.386,0.431,0.816244059850503,2409,0.147,1.93081761006289,74,39.1891891891892,6508,1660,0.385064535955747,0.431179523894756,38.0068027210884
"L Durham","1B",1067,3587,522,992,192,40,147,530,444,679,106,61,0.277,0.356,0.475,0.831566718400752,1705,0.198,0.653902798232695,167,63.4730538922156,4031,1052,0.356239146613744,0.475327571787009,24.4013605442177
"B Butler","DH",1414,5105,592,1479,322,5,147,728,500,840,5,3,0.29,0.354,0.441,0.794213750315629,2252,0.151,0.595238095238095,8,62.5,5605,1320,0.353077609277431,0.441136141038198,34.7278911564626
"M Zunino","C",853,2683,319,539,116,5,147,364,206,1029,2,4,0.201,0.272,0.412,0.670099818260094,1106,0.211,0.20019436345967,6,33.3333333333333,2889,683,0.257874697127034,0.41222512113306,18.2517006802721
"P Alonso","1B",535,1981,314,515,91,5,147,382,227,502,10,1,0.26,0.348,0.534,0.869619629231321,1057,0.274,0.452191235059761,11,90.9090909090909,2208,696,0.336050724637681,0.53356890459364,13.4761904761905
"J Spencer","1B",1553,4908,541,1227,179,27,146,599,407,583,11,19,0.25,0.307,0.387,0.694147363223673,1898,0.137,0.69811320754717,30,36.6666666666667,5315,1140,0.307431796801505,0.386715566422168,33.6164383561644
"C Maldonado","RF",1410,4106,498,1042,227,17,146,618,391,864,34,33,0.254,0.322,0.424,0.742670520943713,1741,0.17,0.452546296296296,67,50.7462686567164,4497,1116,0.318656882366022,0.424013638577691,28.1232876712329
"T Harper","LF",1810,6269,972,1609,256,36,146,567,753,1080,408,116,0.257,0.338,0.379,0.71521970532282,2375,0.122,0.697222222222222,524,77.8625954198473,7022,1539,0.336371404158359,0.37884830116446,42.9383561643836
"J Reddick","OF",1305,4408,597,1157,219,33,146,575,393,791,61,18,0.262,0.321,0.426,0.749346684050623,1880,0.164,0.496839443742099,79,77.2151898734177,4801,1172,0.322849406373672,0.426497277676951,30.1917808219178
"E Alfonzo","3B",1506,5385,777,1532,282,18,146,744,596,617,53,17,0.284,0.357,0.425,0.780677282456035,2288,0.141,0.965964343598055,70,75.7142857142857,5981,1521,0.355793345594382,0.424883936861653,36.8835616438356
"M Wieters","C",1167,3994,440,996,190,5,146,550,368,847,9,4,0.249,0.313,0.409,0.721814266562613,1634,0.16,0.434474616292798,13,69.2307692307692,4362,990,0.312700596056855,0.409113670505759,27.3561643835616
"M Olivo","C",1124,3765,435,905,177,26,145,490,158,1060,53,34,0.24,0.275,0.417,0.687699165103542,1569,0.177,0.149056603773585,87,60.9195402298851,3923,925,0.270966097374458,0.416733067729084,25.9655172413793
"C G?mez","CF",1461,4724,675,1189,236,41,145,546,319,1259,268,74,0.252,0.313,0.411,0.710120650802758,1942,0.159,0.253375694996029,342,78.3625730994152,5043,1221,0.29902835613722,0.411092294665538,32.5793103448276
"J Reyes","SS",1877,7552,1180,2138,387,131,145,719,589,914,517,127,0.283,0.334,0.427,0.761613082919893,3222,0.144,0.644420131291028,644,80.2795031055901,8141,1899,0.33497113376735,0.426641949152542,52.0827586206897
"M Cabrera","LF",1887,6878,895,1962,383,45,144,854,510,891,101,37,0.285,0.334,0.417,0.751432932824273,2867,0.132,0.572390572390572,138,73.1884057971015,7388,1749,0.334596643205198,0.416836289619075,47.7638888888889
"M Muncy","3B",715,2274,404,523,101,7,144,384,410,663,12,2,0.23,0.354,0.471,0.81815199881509,1070,0.241,0.618401206636501,14,85.7142857142857,2684,788,0.347615499254844,0.470536499560246,15.7916666666667
"L Stevens","1B",1012,3332,440,847,185,15,144,531,345,832,9,16,0.254,0.323,0.448,0.772556670206837,1494,0.194,0.414663461538462,25,36,3677,971,0.324177318466141,0.448379351740696,23.1388888888889
"B Molina","C",1362,4812,458,1317,217,6,144,711,208,471,3,7,0.274,0.307,0.411,0.714840554655857,1978,0.137,0.441613588110403,10,30,5020,1169,0.303784860557769,0.411055694098088,33.4166666666667
"J Leonard","LF",1415,5045,614,1342,223,37,144,723,342,1000,163,61,0.266,0.312,0.411,0.723109868984964,2071,0.145,0.342,224,72.7678571428571,5387,1337,0.312604418043438,0.410505450941526,35.0347222222222
"K Young","1B",1205,3897,536,1007,235,17,144,606,336,882,83,49,0.258,0.324,0.438,0.755554937223876,1708,0.18,0.380952380952381,132,62.8787878787879,4233,1142,0.317269076305221,0.438285860918655,27.0625
"C Hayes","3B",1547,5262,580,1379,251,16,144,740,420,918,47,31,0.262,0.316,0.398,0.714561416816874,2094,0.136,0.457516339869281,78,60.2564102564103,5682,1320,0.316613868356213,0.397947548460661,36.5416666666667
"K Suzuki","C",1635,5563,594,1421,295,6,143,730,387,751,20,11,0.255,0.314,0.388,0.6916059740452,2157,0.133,0.515312916111851,31,64.5161290322581,5950,1324,0.303865546218487,0.387740427826712,38.9020979020979
"V Hayes","RF",1495,5249,767,1402,282,36,143,696,712,804,253,97,0.267,0.354,0.416,0.770908249145578,2185,0.149,0.885572139303483,350,72.2857142857143,5961,1463,0.354638483475927,0.416269765669651,36.7062937062937
"J Mauer","C",1858,6930,1018,2123,428,30,143,923,939,1034,52,19,0.306,0.388,0.439,0.827794309304031,3040,0.133,0.908123791102515,71,73.2394366197183,7869,1941,0.389121870631592,0.438672438672439,48.4615384615385
"S Marte","RF",1257,4826,757,1397,258,51,142,566,278,1052,316,94,0.289,0.346,0.452,0.780515464821558,2183,0.163,0.26425855513308,410,77.0731707317073,5104,1323,0.328173981191223,0.452341483630336,33.9859154929577
"W Moon","LF",1458,4843,737,1399,212,60,142,661,644,591,89,68,0.289,0.371,0.445,0.817719700961193,2157,0.156,1.08967851099831,157,56.687898089172,5487,1398,0.372334609075998,0.445385091885195,34.1056338028169
"B Jackson","LF",694,2393,341,598,86,14,141,415,200,841,82,32,0.25,0.309,0.474,0.782051680816703,1135,0.224,0.237812128418549,114,71.9298245614035,2593,756,0.307751639028153,0.47430004178855,16.9716312056738
"S Brosius","3B",1146,3888,544,1001,200,8,141,531,348,699,57,30,0.257,0.323,0.422,0.740271511675352,1640,0.165,0.497854077253219,87,65.5172413793103,4236,1075,0.318460812086874,0.421810699588477,27.5744680851064
"J Jaha","1B",826,2775,470,730,126,5,141,490,430,686,36,17,0.263,0.369,0.465,0.8264389818836,1289,0.202,0.626822157434402,53,67.9245283018868,3205,960,0.361934477379095,0.464504504504504,19.6808510638298
"C Iannetta","C",1197,3563,449,820,181,11,141,502,576,1024,11,10,0.23,0.345,0.406,0.743117313273919,1446,0.176,0.5625,21,52.3809523809524,4139,951,0.337279536119836,0.405837777154084,25.2695035460993
"A Bregman","3B",809,2970,513,818,207,12,140,490,442,480,36,12,0.275,0.374,0.495,0.863897671517836,1469,0.22,0.920833333333333,48,75,3412,1003,0.369284876905041,0.494612794612795,21.2142857142857
"P Higgins","3B",1802,6636,930,1941,374,51,140,1075,800,590,61,59,0.292,0.37,0.428,0.796128733324449,2837,0.136,1.35593220338983,120,50.8333333333333,7436,2005,0.368612157073696,0.427516576250753,47.4
"L Morrison","1B",997,3331,416,792,163,21,140,426,393,740,23,10,0.238,0.323,0.425,0.743604008305277,1417,0.187,0.531081081081081,33,69.6969696969697,3724,842,0.318206229860365,0.425397778444911,23.7928571428571
"T Pendleton","3B",1893,7032,851,1897,356,39,140,946,486,979,127,59,0.27,0.316,0.391,0.708184203191067,2751,0.121,0.496424923391216,186,68.2795698924731,7518,1797,0.316972599095504,0.391211604095563,50.2285714285714
"D Pedroia","2B",1512,6031,922,1805,394,15,140,725,624,654,138,46,0.299,0.365,0.439,0.804219371962616,2649,0.14,0.954128440366973,184,75,6655,1647,0.364988730277986,0.439230641684629,43.0785714285714
"J Kubel","LF",1036,3480,442,913,187,19,140,564,355,834,12,7,0.262,0.33,0.448,0.778340002098038,1558,0.186,0.425659472422062,19,63.1578947368421,3835,1006,0.330638852672751,0.447701149425287,24.8571428571429
"E Renteria","SS",2152,8142,1200,2327,436,29,140,923,718,1182,294,108,0.286,0.343,0.398,0.741738903093122,3241,0.112,0.607445008460237,402,73.134328358209,8860,2123,0.343679458239278,0.398059444853844,58.1571428571429
"J Crede","3B",888,3101,392,787,159,5,140,470,199,459,4,12,0.254,0.304,0.444,0.742515708520223,1376,0.19,0.433551198257081,16,25,3300,862,0.298787878787879,0.443727829732344,22.15
"A Pollock","LF",1034,3657,560,1010,221,32,140,470,282,705,122,28,0.276,0.331,0.469,0.796965662364179,1715,0.193,0.4,150,81.3333333333333,3939,1030,0.328002030972328,0.468963631391851,26.1214285714286
"P Feliz","3B",1302,4254,487,1065,209,25,140,598,230,663,13,12,0.25,0.288,0.41,0.69877172851327,1744,0.16,0.346907993966817,25,52,4484,1085,0.288804638715433,0.409967089797837,30.3857142857143
"B Crawford","SS",1565,5306,640,1340,280,43,140,709,509,1192,45,34,0.253,0.321,0.401,0.71864924245788,2126,0.148,0.427013422818792,79,56.9620253164557,5815,1349,0.317970765262253,0.400678477195628,37.9
"R Devers","3B",692,2712,443,769,189,7,139,456,229,626,24,17,0.284,0.343,0.512,0.851508502014546,1389,0.228,0.365814696485623,41,58.5365853658537,2941,899,0.339340360421625,0.51216814159292,19.5107913669065
"D Segui","1B",1456,4847,683,1412,284,16,139,684,524,687,17,19,0.291,0.359,0.443,0.802996069985457,2145,0.152,0.7627365356623,36,47.2222222222222,5371,1367,0.360454291565816,0.442541778419641,34.8705035971223
"E Gattis","DH",706,2443,299,605,116,12,139,410,167,575,3,3,0.248,0.3,0.476,0.771430139753428,1162,0.228,0.290434782608696,6,50,2610,709,0.295785440613027,0.475644699140401,17.5755395683453
"J Briggs","LF",1366,4117,601,1041,170,43,139,507,663,784,64,49,0.253,0.355,0.416,0.772807920623032,1714,0.163,0.845663265306122,113,56.6371681415929,4780,1108,0.356485355648536,0.416322564974496,29.6187050359712
"W Montanez","1B",1632,5843,645,1604,279,25,139,802,465,751,32,42,0.275,0.327,0.402,0.730186850792742,2350,0.127,0.619174434087883,74,43.2432432432432,6308,1447,0.327996195307546,0.402190655485196,42.0359712230216
"E Yost","3B",2109,7346,1215,1863,337,56,139,683,1614,920,72,66,0.254,0.394,0.371,0.759552726702579,2729,0.117,1.75434782608696,138,52.1739130434783,8960,1898,0.388058035714286,0.371494690988293,52.8489208633094
"B Gardner","LF",1688,5737,943,1470,251,73,139,578,699,1245,274,64,0.256,0.342,0.398,0.735128048573731,2284,0.142,0.56144578313253,338,81.0650887573965,6436,1521,0.337010565568676,0.398117483005055,41.273381294964
"E Rosario","LF",889,3294,469,889,165,26,138,474,176,670,53,23,0.27,0.305,0.461,0.768361478121954,1520,0.191,0.262686567164179,76,69.7368421052632,3470,943,0.306916426512968,0.461445051608986,23.8695652173913
"M Chapman","3B",731,2641,423,638,154,17,138,374,320,813,7,11,0.242,0.329,0.47,0.79305846636081,1240,0.228,0.39360393603936,18,38.8888888888889,2961,797,0.323539344815941,0.469519121544869,19.1376811594203
"J Cardenal","CF",2017,6964,936,1913,333,46,138,775,608,807,329,139,0.275,0.333,0.395,0.728112323494188,2752,0.12,0.753407682775712,468,70.2991452991453,7572,1711,0.332937136819863,0.395175186674325,50.463768115942
"D Murphy","1B",1452,5308,710,1572,371,29,138,735,364,709,68,25,0.296,0.341,0.455,0.796299435718818,2415,0.159,0.513399153737659,93,73.1182795698925,5672,1445,0.34132581100141,0.454973624717408,38.463768115942
"R Connor","1B",1997,7794,1620,2467,441,233,138,1322,1002,449,244,0,0.317,0.397,0.486,0.880398694066622,3788,0.169,2.23162583518931,244,100,8796,2942,0.394383810823101,0.486014883243521,56.4782608695652
"S Castro","3B",1573,6148,698,1722,319,40,138,678,338,1108,89,52,0.28,0.319,0.412,0.729936366621988,2535,0.132,0.305054151624549,141,63.1205673758865,6486,1376,0.317607153869874,0.412329212752114,44.5507246376812
"M Lawton","LF",1334,4763,756,1273,267,17,138,631,681,613,165,66,0.267,0.368,0.417,0.776311261047725,1988,0.15,1.11092985318108,231,71.4285714285714,5444,1387,0.358927259368112,0.417384001679614,34.5144927536232
"E Williams","C",889,3058,361,756,115,6,138,457,298,574,2,5,0.247,0.318,0.424,0.738197782872413,1297,0.177,0.519163763066202,7,28.5714285714286,3356,818,0.314064362336114,0.424133420536298,22.1594202898551
"B Mazeroski","2B",2163,7755,769,2016,294,62,138,853,447,706,27,23,0.26,0.299,0.367,0.66753954901786,2848,0.107,0.63314447592068,50,54,8202,1622,0.300292611558157,0.367246937459703,56.195652173913
"J Robinson","2B",1382,4877,947,1518,273,54,137,734,740,291,197,30,0.311,0.409,0.474,0.875645782091325,2310,0.163,2.54295532646048,227,86.784140969163,5617,1681,0.401993946946769,0.473651835144556,35.5985401459854
"C Seager","SS",790,3023,487,867,188,13,137,448,316,606,15,6,0.287,0.357,0.494,0.84784714810492,1492,0.207,0.521452145214521,21,71.4285714285714,3339,935,0.354297693920335,0.493549454184585,22.0656934306569
"A Gonzalez","SS",1396,4977,623,1209,274,27,137,536,392,1165,97,48,0.243,0.302,0.391,0.689593774124991,1948,0.148,0.336480686695279,145,66.8965517241379,5369,1159,0.298193332091637,0.391400442033353,36.3284671532847
"S Buechele","3B",1334,4266,501,1046,183,21,137,547,408,842,17,28,0.245,0.316,0.394,0.705362940815728,1682,0.149,0.484560570071259,45,37.7777777777778,4674,1048,0.311082584510056,0.394280356305673,31.1386861313869
"D Daulton","C",1161,3630,511,891,197,25,137,588,629,726,50,10,0.245,0.357,0.427,0.783613052120384,1549,0.182,0.866391184573003,60,83.3333333333333,4259,1099,0.356891289034985,0.426721763085399,26.4963503649635
"E Hinske","3B",1387,3797,549,947,240,18,137,522,452,949,61,21,0.249,0.332,0.43,0.759593684005526,1634,0.181,0.476290832455216,82,74.390243902439,4249,1071,0.329253942104024,0.430339741901501,27.7153284671533
"T Nixon","RF",1092,3627,579,995,222,28,137,555,504,689,30,13,0.274,0.364,0.464,0.827161695177719,1684,0.19,0.731494920174166,43,69.7674418604651,4131,1134,0.362866134107964,0.464295561069755,26.4744525547445
"W Ramos","C",990,3492,362,946,151,2,136,534,245,638,1,3,0.271,0.318,0.432,0.750835427649759,1509,0.161,0.384012539184953,4,25,3737,896,0.318704843457319,0.43213058419244,25.6764705882353
"R Barajas","C",1114,3460,396,812,187,1,136,480,207,638,2,2,0.235,0.284,0.407,0.685109262268853,1409,0.172,0.324451410658307,4,50,3667,876,0.277883828742842,0.407225433526012,25.4411764705882
"D Johnson","2B",1435,4797,564,1252,242,18,136,609,559,675,33,25,0.261,0.34,0.404,0.742127968329721,1938,0.143,0.828148148148148,58,56.8965517241379,5356,1173,0.338125466766243,0.404002501563477,35.2720588235294
"C Crawford","LF",1716,6655,998,1931,309,123,136,766,377,1067,480,109,0.29,0.33,0.435,0.763074886170252,2894,0.145,0.353327085285848,589,81.4940577249576,7032,1764,0.328213879408419,0.434861006761833,48.9338235294118
"M Nokes","C",902,2735,310,695,96,4,136,422,200,395,8,7,0.254,0.308,0.441,0.74625664535378,1207,0.187,0.506329113924051,15,53.3333333333333,2935,732,0.304940374787053,0.441316270566728,20.1102941176471
"J Fournier","1B",1530,5208,822,1631,252,113,136,859,587,408,145,94,0.313,0.392,0.483,0.866038675482996,2517,0.17,1.43872549019608,239,60.6694560669456,5795,1681,0.38274374460742,0.483294930875576,38.2941176470588
"A Rowand","CF",1358,4374,613,1193,267,18,136,536,261,914,67,30,0.273,0.33,0.435,0.748999604902757,1904,0.162,0.285557986870897,97,69.0721649484536,4635,1149,0.313700107874865,0.435299497027892,32.1617647058824
"H Lopez","LF",1450,4644,623,1251,193,37,136,591,418,696,16,23,0.269,0.33,0.415,0.744440258622538,1926,0.146,0.600574712643678,39,41.025641025641,5062,1214,0.329711576451995,0.414728682170543,34.1470588235294
"T Gwynn","RF",2440,9288,1383,3141,543,85,135,1138,790,434,319,125,0.338,0.388,0.459,0.848606216045423,4259,0.121,1.82027649769585,444,71.8468468468468,10078,2521,0.390057551101409,0.458548664944014,68.8
"G McQuinn","1B",1550,5747,832,1588,315,64,135,794,712,634,32,31,0.276,0.357,0.424,0.779965599559029,2436,0.148,1.12302839116719,63,50.7936507936508,6459,1626,0.356092274345874,0.423873325213155,42.5703703703704
"T Jackson","SS",1657,6086,833,1768,291,86,135,929,412,565,71,13,0.291,0.337,0.433,0.768613047802469,2636,0.142,0.729203539823009,84,84.5238095238095,6498,1762,0.33548784241305,0.433125205389418,45.0814814814815
"R Collins","1B",1084,3784,615,1121,205,65,135,659,356,373,18,0,0.296,0.36,0.492,0.848570896017812,1861,0.196,0.954423592493298,18,100,4140,1274,0.356763285024155,0.491807610993657,28.0296296296296
"A Garc?a","RF",1052,3800,484,1006,150,16,135,510,257,989,49,32,0.265,0.319,0.419,0.730524304969967,1593,0.154,0.259858442871587,81,60.4938271604938,4057,994,0.311313778654178,0.419210526315789,28.1481481481481
"J Presley","3B",959,3546,413,875,181,14,135,495,210,859,9,14,0.247,0.29,0.42,0.708780896983326,1489,0.173,0.244470314318976,23,39.1304347826087,3756,908,0.288871139510117,0.419909757473209,26.2666666666667
"L Scott","DH",889,2810,370,725,181,20,135,436,334,662,17,7,0.258,0.34,0.481,0.817614979218168,1351,0.223,0.504531722054381,24,70.8333333333333,3144,806,0.336832061068702,0.480782918149466,20.8148148148148
"J Soler","LF",737,2542,340,614,141,3,135,379,300,791,10,5,0.242,0.327,0.459,0.780298445648641,1166,0.217,0.379266750948167,15,66.6666666666667,2842,719,0.321604503870514,0.458693941778127,18.8296296296296
"D Gregorius","SS",1077,3893,503,999,180,27,134,530,254,612,37,16,0.257,0.308,0.42,0.722130717453888,1635,0.163,0.415032679738562,53,69.811320754717,4147,1033,0.302146129732337,0.419984587721552,29.0522388059701
"P Blair","CF",1947,6042,776,1513,282,55,134,620,449,877,171,93,0.25,0.302,0.382,0.684091883697495,2307,0.132,0.511972633979475,264,64.7727272727273,6491,1396,0.302264674164227,0.381827209533267,45.089552238806
"M Hall","LF",1276,4237,568,1171,229,25,134,620,267,575,31,22,0.276,0.318,0.437,0.756373481354103,1852,0.161,0.464347826086957,53,58.4905660377358,4504,1188,0.319271758436945,0.437101722917158,31.6194029850746
"T Haller","C",1294,3935,461,1011,153,31,134,504,477,593,14,30,0.257,0.34,0.414,0.750985011422008,1628,0.157,0.804384485666105,44,31.8181818181818,4412,965,0.337262012692656,0.413722998729352,29.365671641791
"J Buck","C",1090,3612,389,844,172,9,134,491,307,959,6,12,0.234,0.301,0.398,0.691261048411959,1436,0.164,0.320125130344108,18,33.3333333333333,3919,880,0.293697371778515,0.397563676633444,26.955223880597
"J Realmuto","C",1008,3690,521,1017,208,29,134,515,269,809,79,18,0.276,0.332,0.457,0.78146906879526,1685,0.181,0.332509270704574,97,81.4432989690722,3959,1036,0.324829502399596,0.456639566395664,27.5373134328358
"C Dickerson","LF",1036,3530,471,992,230,36,134,452,221,773,30,24,0.281,0.324,0.48,0.803833689675199,1696,0.199,0.285899094437257,54,55.5555555555556,3751,923,0.323380431884831,0.480453257790368,26.3432835820896
"E Joost","SS",1575,5606,874,1339,238,35,134,601,1043,827,61,31,0.239,0.361,0.366,0.723750609468284,2049,0.127,1.26118500604595,92,66.304347826087,6649,1475,0.358249360806136,0.365501248662148,41.8358208955224
"C Baerga","2B",1630,5439,731,1583,279,17,134,774,291,580,59,24,0.291,0.332,0.423,0.749554747610095,2298,0.132,0.501724137931034,83,71.0843373493976,5730,1505,0.327050610820244,0.422504136789851,40.589552238806
"D Bell","RF",1210,4578,642,1262,232,15,134,668,377,955,170,51,0.276,0.336,0.421,0.751484725570766,1926,0.145,0.394764397905759,221,76.9230769230769,4955,1310,0.330776992936428,0.420707732634338,34.1641791044776
"E Whitt","C",1328,3774,447,938,176,15,134,534,436,491,22,26,0.249,0.324,0.41,0.736010734781169,1546,0.161,0.887983706720978,48,45.8333333333333,4210,981,0.326365795724466,0.409644939056704,28.1641791044776
"M Pagliarulo","3B",1245,3901,462,942,206,18,134,505,343,785,18,16,0.241,0.306,0.407,0.709342815745304,1586,0.166,0.436942675159236,34,52.9411764705882,4244,967,0.302780395852969,0.406562419892335,29.1119402985075
"F Malzone","3B",1441,5428,647,1486,239,21,133,728,337,434,14,14,0.274,0.315,0.399,0.715260564699055,2166,0.125,0.776497695852535,28,50,5765,1375,0.316218560277537,0.399042004421518,40.812030075188
"T Hern?ndez","RF",655,2334,352,608,133,10,133,380,188,748,35,20,0.26,0.318,0.497,0.812623378706118,1160,0.237,0.251336898395722,55,63.6363636363636,2522,732,0.315622521808089,0.497000856898029,17.5488721804511
"M Jones","CF",1002,3091,485,778,132,31,133,415,383,756,65,40,0.252,0.347,0.444,0.777742669257061,1371,0.192,0.506613756613757,105,61.9047619047619,3474,900,0.33419689119171,0.443545778065351,23.2406015037594
"M Conforto","RF",761,2568,401,652,141,4,133,397,362,719,18,11,0.254,0.355,0.467,0.8133648049504,1200,0.213,0.503477051460362,29,62.0689655172414,2930,798,0.346075085324232,0.467289719626168,19.3082706766917
"N Siebern","1B",1406,4481,662,1217,206,38,132,636,708,748,18,25,0.272,0.369,0.423,0.793873741721594,1895,0.151,0.946524064171123,43,41.8604651162791,5189,1298,0.37097706687223,0.422896674849364,33.9469696969697
"J Rivera","LF",1058,3471,425,950,182,4,132,539,253,448,17,26,0.274,0.323,0.443,0.76556351057914,1536,0.169,0.564732142857143,43,39.5348837209302,3724,964,0.323039742212675,0.442523768366465,26.2954545454545
"A Martin","LF",1232,4242,664,1172,220,48,132,485,390,879,173,65,0.276,0.339,0.444,0.781349470994472,1884,0.168,0.443686006825939,238,72.6890756302521,4632,1149,0.337219343696028,0.444130127298444,32.1363636363636
"C Ross","RF",1073,3453,449,904,211,13,132,508,282,800,33,13,0.262,0.322,0.445,0.762656999268432,1537,0.183,0.3525,46,71.7391304347826,3735,957,0.317536813922356,0.445120185346076,26.1590909090909
"Z Wheat","LF",2410,9106,1289,2884,476,172,132,1248,650,559,205,49,0.317,0.367,0.45,0.812491203102235,4100,0.133,1.16279069767442,254,80.7086614173228,9756,2537,0.362238622386224,0.450252580716011,68.9848484848485
"Y Puig","RF",861,3015,441,834,159,21,132,415,297,681,79,38,0.277,0.348,0.475,0.816112372918019,1431,0.198,0.436123348017621,117,67.5213675213675,3312,856,0.341485507246377,0.474626865671642,22.8409090909091
"D Long","1B",1014,3020,384,805,135,33,132,467,353,460,10,3,0.267,0.341,0.464,0.807552967370411,1402,0.197,0.767391304347826,13,76.9230769230769,3373,851,0.343314556774385,0.464238410596026,22.8787878787879
"W Covington","LF",1075,2978,355,832,128,17,131,499,247,414,7,4,0.279,0.337,0.466,0.800322468125426,1387,0.187,0.596618357487923,11,63.6363636363636,3225,854,0.334573643410853,0.465748824714574,22.7328244274809
"K Harrelson","1B",900,2941,374,703,94,14,131,421,382,577,53,30,0.239,0.325,0.414,0.740657036473046,1218,0.175,0.662045060658579,83,63.855421686747,3323,795,0.326512187782125,0.414144848690921,22.4503816793893
"J Milner","1B",1215,3436,455,855,140,16,131,498,504,473,31,22,0.249,0.344,0.413,0.758195103502479,1420,0.164,1.06553911205074,53,58.4905660377358,3940,953,0.34492385786802,0.413271245634459,26.2290076335878
"J Kuhel","1B",2104,7984,1236,2212,412,111,131,1049,980,612,178,90,0.277,0.359,0.406,0.761777403535317,3239,0.129,1.60130718954248,268,66.4179104477612,8964,2285,0.356091030789826,0.405686372745491,60.9465648854962
"S Kemp","LF",1168,4058,581,1128,179,25,130,634,576,605,39,24,0.278,0.367,0.431,0.798224514500894,1747,0.153,0.952066115702479,63,61.9047619047619,4634,1215,0.367716875269745,0.430507639231148,31.2153846153846
"M Franco","3B",923,3309,364,809,163,4,130,467,221,569,5,1,0.244,0.293,0.414,0.705807065801313,1370,0.17,0.388400702987698,6,83.3333333333333,3530,831,0.291784702549575,0.414022363251738,25.4538461538462
"M Greenwell","LF",1269,4623,657,1400,275,38,130,726,460,364,80,43,0.303,0.368,0.463,0.829044821143153,2141,0.16,1.26373626373626,123,65.0406504065041,5083,1383,0.365925634467834,0.463119186675319,35.5615384615385
"C Crisp","CF",1586,5930,877,1572,308,57,130,639,561,865,309,79,0.265,0.327,0.402,0.730632451782374,2384,0.137,0.648554913294798,388,79.6391752577319,6491,1516,0.328608843013403,0.402023608768971,45.6153846153846
"W Marshall","RF",1247,4233,583,1160,163,39,130,604,458,219,14,4,0.274,0.347,0.423,0.768019977637109,1791,0.149,2.09132420091324,18,77.7777777777778,4691,1187,0.3449157962055,0.423104181431609,32.5615384615385
"J Orta","2B",1755,5829,733,1619,267,63,130,745,500,716,79,60,0.278,0.334,0.412,0.746885569862371,2402,0.134,0.698324022346369,139,56.8345323741007,6329,1478,0.334808026544478,0.412077543317893,44.8384615384615
"S Casey","1B",1405,5066,690,1531,322,12,130,735,477,577,18,8,0.302,0.367,0.447,0.80975179586877,2267,0.145,0.826689774696707,26,69.2307692307692,5543,1425,0.36225870467256,0.44749309119621,38.9692307692308
"M Epstein","1B",907,2854,362,695,93,16,130,380,448,645,7,17,0.244,0.358,0.424,0.770120209153145,1210,0.18,0.694573643410853,24,29.1666666666667,3302,742,0.346153846153846,0.423966362999299,21.9538461538462
"C Guillen","SS",1305,4673,733,1331,266,51,124,660,510,804,74,47,0.285,0.355,0.443,0.798383941244977,2071,0.158,0.634328358208955,121,61.1570247933884,5183,1393,0.355199691298476,0.443184249946501,37.6854838709677
"S Drew","SS",1268,4403,565,1109,258,63,123,524,435,926,41,19,0.252,0.318,0.423,0.742033622270959,1862,0.171,0.469762419006479,60,68.3333333333333,4838,1089,0.319140140553948,0.422893481717011,35.7967479674797
"O Cabrera","SS",1985,7562,985,2055,459,32,123,854,514,745,216,57,0.272,0.317,0.39,0.707814737774795,2947,0.118,0.68993288590604,273,79.1208791208791,8076,1839,0.318103021297672,0.389711716477122,61.479674796748
"D Bell","3B",1403,4826,587,1239,267,18,123,589,428,687,19,20,0.257,0.32,0.396,0.713262178552887,1911,0.139,0.622998544395924,39,48.7179487179487,5254,1176,0.317282070803198,0.395980107749689,39.2357723577236
"E Valentine","OF",894,3166,380,881,169,15,123,474,180,462,59,37,0.278,0.315,0.458,0.774770338915532,1449,0.18,0.38961038961039,96,61.4583333333333,3346,854,0.317095038852361,0.457675300063171,25.739837398374
"J Randa","3B",1522,5428,697,1543,327,36,123,739,432,738,42,26,0.284,0.339,0.426,0.762786059391199,2311,0.142,0.585365853658537,68,61.7647058823529,5860,1436,0.33703071672355,0.425755342667649,44.130081300813
"K Phelps","DH",761,1854,308,443,64,7,123,313,390,449,10,7,0.239,0.374,0.48,0.851255271158184,890,0.241,0.868596881959911,17,58.8235294117647,2244,621,0.371212121212121,0.480043149946063,15.0731707317073
"W Upshaw","1B",1264,4203,596,1103,199,45,123,528,452,642,88,59,0.262,0.335,0.419,0.753035847495766,1761,0.157,0.70404984423676,147,59.8639455782313,4655,1124,0.334049409237379,0.418986438258387,34.1707317073171
"B Miller","1B",1030,3083,391,730,129,30,123,401,341,864,43,18,0.237,0.314,0.418,0.730566950657965,1288,0.181,0.394675925925926,61,70.4918032786885,3424,792,0.312792056074766,0.417774894583198,25.0650406504065
"K Henderson","CF",1444,4553,595,1168,216,26,122,576,589,763,86,42,0.257,0.343,0.396,0.73747883841489,1802,0.139,0.771952817824377,128,67.1875,5142,1171,0.341695838195255,0.395783000219635,37.3196721311475
"B Wilkerson","LF",972,3187,500,788,193,28,122,399,492,947,53,43,0.247,0.35,0.44,0.788146548397169,1403,0.193,0.519535374868004,96,55.2083333333333,3679,899,0.347920630606143,0.440225917791026,26.1229508196721
"D Lock","CF",921,2695,359,642,92,12,122,373,373,776,30,29,0.238,0.331,0.417,0.747903065457545,1124,0.179,0.480670103092784,59,50.8474576271186,3068,732,0.330834419817471,0.417068645640074,22.0901639344262
"J Ferguson","C",1013,3001,407,719,121,11,122,445,562,607,22,12,0.24,0.358,0.409,0.768725421585077,1228,0.169,0.925864909390445,34,64.7058823529412,3563,852,0.359528487229862,0.409196934355215,24.5983606557377
"M Cordova","LF",952,3419,480,938,192,18,122,540,329,730,57,36,0.274,0.344,0.448,0.78613119353428,1532,0.174,0.450684931506849,93,61.2903225806452,3748,1020,0.338046958377802,0.448084235156478,28.0245901639344
"W Cordero","LF",1247,4311,587,1178,261,19,122,566,325,775,49,19,0.273,0.33,0.428,0.751712916513308,1843,0.155,0.419354838709677,68,72.0588235294118,4636,1153,0.324201898188093,0.427511018325215,35.3360655737705
"N Esasky","1B",810,2703,336,677,120,21,122,427,314,712,18,14,0.25,0.329,0.446,0.77427295393927,1205,0.196,0.441011235955056,32,56.25,3017,763,0.328471992045078,0.445800961894192,22.155737704918
"G Jones","1B",911,2924,347,734,178,12,122,400,265,680,28,10,0.251,0.312,0.445,0.758544783946526,1302,0.194,0.389705882352941,38,73.6842105263158,3189,747,0.313264346190028,0.445280437756498,23.9672131147541
"H Stovey","1B",1486,6138,1492,1771,347,174,122,908,663,343,509,0,0.289,0.361,0.461,0.819276620093388,2832,0.172,1.93294460641399,509,100,6801,2400,0.357888545802088,0.4613880742913,50.3114754098361
"J Blauser","SS",1407,4522,691,1187,217,33,122,513,569,937,65,41,0.262,0.354,0.406,0.750937449693769,1836,0.144,0.607257203842049,106,61.3207547169811,5091,1204,0.344922412099784,0.406015037593985,37.0655737704918
"J Hall","CF",963,2848,387,724,100,24,121,391,287,529,38,18,0.254,0.321,0.434,0.75612567872695,1235,0.18,0.542533081285444,56,67.8571428571429,3135,778,0.322488038277512,0.433637640449438,23.5371900826446
"A Kearns","RF",1125,3606,522,914,187,13,121,494,475,898,33,21,0.253,0.351,0.413,0.753557977304563,1490,0.16,0.528953229398664,54,61.1111111111111,4081,1016,0.340357755452095,0.413200221852468,29.801652892562
"D Ford","RF",1153,4163,598,1123,214,38,121,566,303,722,61,37,0.27,0.324,0.427,0.745916809837888,1776,0.157,0.419667590027701,98,62.2448979591837,4466,1164,0.319301388266906,0.426615421570982,34.4049586776859
"G Roenicke","LF",1064,2708,367,670,135,4,121,410,406,428,16,20,0.247,0.351,0.434,0.779805120819969,1176,0.187,0.948598130841122,36,44.4444444444444,3114,777,0.34553628773282,0.434268833087149,22.3801652892562
"K Moreland","RF",1306,4581,511,1279,214,14,121,674,405,515,28,33,0.279,0.335,0.411,0.749009604101701,1884,0.132,0.786407766990291,61,45.9016393442623,4986,1185,0.337745687926193,0.411263916175508,37.8595041322314
"J Gyorko","2B",847,2693,317,659,111,5,121,370,248,670,14,6,0.245,0.31,0.424,0.732832220954423,1143,0.179,0.370149253731343,20,70,2941,687,0.308398503910235,0.424433717044189,22.2561983471074
"J Lowrie","SS",1307,4615,590,1185,292,17,121,594,503,895,8,3,0.257,0.33,0.406,0.735883506770022,1874,0.149,0.562011173184358,11,72.7272727272727,5118,1184,0.329816334505666,0.406067172264355,38.1404958677686
"W Gross","3B",1106,3125,373,727,126,9,121,396,482,496,24,22,0.233,0.337,0.395,0.730061591350152,1234,0.162,0.971774193548387,46,52.1739130434783,3607,769,0.335181591350152,0.39488,25.8264462809917
"R Acu?a","RF",517,1996,396,553,102,7,121,297,263,584,108,32,0.277,0.37,0.517,0.878255847684745,1032,0.24,0.450342465753425,140,77.1428571428572,2259,693,0.361221779548473,0.517034068136273,16.495867768595
"M McManus","2B",1831,6660,1008,1926,401,88,120,996,675,558,126,91,0.289,0.357,0.43,0.784481106873745,2863,0.141,1.20967741935484,217,58.0645161290323,7335,2004,0.354601226993865,0.42987987987988,55.5
"B Jacoby","3B",1311,4520,535,1220,204,24,120,545,439,764,16,25,0.27,0.334,0.405,0.73985298920172,1832,0.135,0.574607329842932,41,39.0243902439024,4959,1080,0.334543254688445,0.405309734513274,37.6666666666667
"S Spiezio","1B",1274,3899,517,996,225,27,119,549,412,594,33,23,0.255,0.329,0.419,0.745175219645147,1632,0.164,0.693602693602694,56,58.9285714285714,4311,1066,0.326606355833913,0.418568863811234,32.7647058823529
"G Cravath","RF",1226,3951,575,1134,232,83,119,719,561,514,89,9,0.287,0.38,0.478,0.853771702019957,1889,0.191,1.09143968871595,98,90.8163265306122,4512,1294,0.375664893617021,0.478106808402936,33.2016806722689
"R Greer","LF",1027,3829,643,1166,258,25,119,614,519,555,31,15,0.305,0.387,0.478,0.865727238238755,1831,0.173,0.935135135135135,46,67.3913043478261,4348,1257,0.387534498620055,0.478192739618699,32.1764705882353
"R Thompson","2B",1304,4612,671,1187,238,39,119,458,439,987,103,62,0.257,0.329,0.403,0.725212202404511,1860,0.146,0.444782168186424,165,62.4242424242424,5051,1129,0.321916452187686,0.403295750216826,38.7563025210084
"F Hayes","C",1364,4493,545,1164,213,32,119,628,564,627,30,20,0.259,0.343,0.4,0.741882622677484,1798,0.141,0.899521531100478,50,60,5057,1173,0.341704567925648,0.400178054751836,37.7563025210084
"M Cochrane","C",1482,5169,1041,1652,333,64,119,832,857,217,64,46,0.32,0.419,0.478,0.89421114295652,2470,0.158,3.94930875576037,110,58.1818181818182,6026,1873,0.416362429472287,0.477848713484233,43.436974789916
"Z Bonura","1B",917,3582,600,1099,232,29,119,704,404,180,19,7,0.307,0.38,0.487,0.864506930034014,1746,0.18,2.24444444444444,26,73.0769230769231,3986,1304,0.377069744104365,0.487437185929648,30.1008403361345
"J Payton","CF",1259,4154,561,1157,193,30,119,522,255,503,47,32,0.279,0.323,0.425,0.745627160184561,1767,0.146,0.506958250497018,79,59.4936708860759,4409,1083,0.320254025856203,0.425373134328358,34.9075630252101
"E Kranepool","1B",1853,5436,536,1418,225,25,118,614,454,581,15,27,0.261,0.316,0.377,0.694390474869792,2047,0.116,0.781411359724613,42,35.7142857142857,5890,1150,0.317826825127334,0.376563649742458,46.0677966101695
"B Grieve","RF",976,3215,471,864,192,5,118,492,466,784,24,5,0.269,0.367,0.442,0.802994486841977,1420,0.173,0.594387755102041,29,82.7586206896552,3681,963,0.361314860092366,0.441679626749611,27.2457627118644
"B Gilkey","LF",1239,4061,606,1115,244,24,118,546,466,708,115,71,0.275,0.352,0.434,0.782874941110947,1761,0.159,0.65819209039548,186,61.8279569892473,4527,1152,0.349237905897946,0.433637035213002,34.4152542372881
"C Patterson","CF",1230,4171,571,1050,197,34,118,431,206,933,218,64,0.252,0.29,0.4,0.687098385465271,1669,0.148,0.220793140407288,282,77.3049645390071,4377,1002,0.286954535069682,0.400143850395589,35.3474576271186
"L Cardenas","SS",1941,6707,662,1725,285,49,118,689,522,1135,39,48,0.257,0.311,0.367,0.677910544649331,2462,0.11,0.459911894273128,87,44.8275862068966,7229,1351,0.310831373633974,0.367079171015357,56.8389830508475
"M Adams","1B",856,2421,297,624,130,6,118,399,165,643,4,4,0.258,0.306,0.463,0.767723160934246,1120,0.205,0.256609642301711,8,50,2586,696,0.305104408352668,0.462618752581578,20.5169491525424
"T Walker","OF",1428,5067,696,1423,244,71,118,679,416,504,129,47,0.281,0.339,0.427,0.762280138826214,2163,0.146,0.825396825396825,176,73.2954545454545,5483,1375,0.335400328287434,0.42687981053878,42.9406779661017
"K Bass","RF",1571,4838,609,1308,248,40,118,611,357,667,151,73,0.27,0.323,0.411,0.731827475857832,1990,0.141,0.535232383808096,224,67.4107142857143,5195,1220,0.320500481231954,0.411326994625878,41
"J Ryan","OF",234,8164,1642,2512,451,157,118,1093,803,361,418,0,0.308,0.375,0.444,0.814446330977753,3631,0.136,2.22437673130194,418,100,8967,2735,0.369688859150217,0.444757471827535,69.1864406779661
"M Easler","LF",1151,3677,465,1078,189,25,118,522,321,696,20,25,0.293,0.349,0.454,0.804371522176645,1671,0.161,0.461206896551724,45,44.4444444444444,3998,987,0.349924962481241,0.454446559695404,31.1610169491525
"W Boggs","3B",2440,9180,1513,3010,578,61,118,1014,1412,745,24,35,0.328,0.415,0.443,0.860186419314285,4064,0.115,1.89530201342282,59,40.6779661016949,10592,2527,0.417484894259819,0.442701525054466,77.7966101694915
"D Pasqua","LF",904,2620,341,638,129,15,117,390,335,642,7,10,0.244,0.33,0.438,0.767440358559047,1148,0.194,0.521806853582555,17,41.1764705882353,2955,731,0.32927241962775,0.438167938931298,22.3931623931624
"G Maddox","CF",1749,6331,777,1802,337,62,117,754,323,781,248,92,0.285,0.32,0.413,0.732245736968159,2614,0.128,0.413572343149808,340,72.9411764705882,6654,1531,0.319356777877968,0.412888959090191,54.1111111111111
"J King","RF",1125,2918,374,699,112,19,117,401,363,401,23,8,0.24,0.326,0.411,0.734922380064755,1200,0.171,0.905236907730673,31,74.1935483870968,3281,775,0.323681804327949,0.411240575736806,24.9401709401709
"C Laabs","LF",950,3102,467,813,151,44,117,509,389,595,32,22,0.262,0.346,0.452,0.796602796063415,1403,0.19,0.653781512605042,54,59.2592592592593,3491,976,0.344313950157548,0.452288845905867,26.5128205128205
"T Speaker","CF",2792,10195,1881,3515,792,222,117,1529,1381,220,432,129,0.345,0.428,0.5,0.923385414954347,5102,0.155,6.27727272727273,561,77.0053475935829,11576,3410,0.42294402211472,0.500441392839627,87.1367521367521
"I Suzuki","RF",2653,9934,1420,3089,362,96,117,780,647,1080,509,117,0.311,0.355,0.402,0.755139273139019,3994,0.091,0.599074074074074,626,81.3099041533546,10581,2200,0.35308571968623,0.402053553452788,84.9059829059829
"W Contreras","C",736,2489,356,640,134,10,117,365,279,687,22,17,0.257,0.349,0.46,0.792032776586925,1145,0.203,0.406113537117904,39,56.4102564102564,2768,721,0.332008670520231,0.460024106066693,21.2735042735043
"K Gruber","3B",938,3159,431,818,148,24,117,443,197,504,80,33,0.259,0.307,0.432,0.73454215041422,1365,0.173,0.390873015873016,113,70.7964601769911,3356,874,0.302443384982122,0.432098765432099,27
"T Cobb","CF",3034,11429,2246,4191,723,297,117,1938,1249,357,892,178,0.367,0.433,0.513,0.941733037669235,5859,0.146,3.49859943977591,1070,83.3644859813084,12678,4184,0.429089761792081,0.512643275877155,97.6837606837607
"M Stanley","OF",1517,5022,641,1243,201,48,117,500,371,564,44,23,0.248,0.298,0.377,0.675820050225143,1891,0.129,0.657801418439716,67,65.6716417910448,5393,1141,0.2992768403486,0.376543209876543,42.9230769230769
"R Reichardt","LF",997,3307,391,864,109,24,116,445,263,672,40,41,0.261,0.326,0.414,0.729656640400339,1369,0.153,0.391369047619048,81,49.3827160493827,3570,836,0.315686274509804,0.413970365890535,28.5086206896552
"J Lowenstein","LF",1368,3476,510,881,137,18,116,441,446,596,128,78,0.253,0.337,0.403,0.741684950903962,1402,0.15,0.748322147651007,206,62.1359223300971,3922,951,0.338347781744008,0.403337169159954,29.9655172413793
"B Miller","RF",1821,6212,946,1934,389,96,116,990,383,340,127,82,0.311,0.359,0.461,0.812208926253425,2863,0.15,1.12647058823529,209,60.7655502392344,6595,1936,0.351326762699014,0.460882163554411,53.551724137931
"S Lopata","C",853,2601,375,661,116,25,116,397,393,497,18,11,0.254,0.351,0.452,0.803786735331486,1175,0.198,0.790744466800805,29,62.0689655172414,2994,772,0.352037408149633,0.451749327181853,22.4224137931034
"C Sabo","3B",911,3354,494,898,214,17,116,426,274,460,120,49,0.268,0.326,0.445,0.768481281545049,1494,0.177,0.595652173913043,169,71.0059171597633,3628,920,0.323042998897464,0.445438282647585,28.9137931034483
"T Lee","1B",1099,3740,476,958,191,16,115,488,457,704,59,20,0.256,0.337,0.408,0.745166970550648,1526,0.152,0.649147727272727,79,74.6835443037975,4197,964,0.337145580176316,0.408021390374332,32.5217391304348
"A Ramirez","SS",1371,5134,601,1387,249,17,115,590,263,650,143,63,0.27,0.307,0.392,0.69820689891129,2015,0.122,0.404615384615385,206,69.4174757281553,5397,1191,0.305725403001668,0.392481495909622,44.6434782608696
"C Monroe","LF",814,2691,368,678,146,9,115,433,188,588,19,18,0.252,0.301,0.441,0.741898851342046,1187,0.189,0.319727891156463,37,51.3513513513513,2879,801,0.300798888502952,0.441099962839093,23.4
"S Stewart","LF",1386,5574,853,1653,315,41,115,580,504,684,196,71,0.297,0.36,0.43,0.784559959847423,2395,0.133,0.736842105263158,267,73.4082397003745,6078,1433,0.354886475814413,0.42967348403301,48.4695652173913
"B Robertson","1B",829,2385,283,578,93,10,115,368,317,546,7,9,0.242,0.331,0.434,0.765617672754245,1036,0.192,0.580586080586081,16,43.75,2702,651,0.331236121391562,0.434381551362683,20.7391304347826
"G Freese","3B",1115,3446,429,877,161,28,115,432,243,535,51,26,0.254,0.305,0.418,0.721190919593269,1439,0.164,0.454205607476636,77,66.2337662337662,3689,861,0.303605313092979,0.41758560650029,29.9652173913043
"D Hurst","1B",905,3275,510,976,190,28,115,610,391,210,41,0,0.298,0.375,0.478,0.851359261711706,1567,0.18,1.86190476190476,41,100,3666,1120,0.372885979268958,0.478473282442748,28.4782608695652
"M Thames","LF",640,1827,256,450,83,4,115,301,159,510,3,9,0.246,0.309,0.485,0.79159452786914,886,0.239,0.311764705882353,12,25,1986,557,0.306646525679758,0.484948002189381,15.8869565217391
"J Lynch","LF",1184,2879,364,798,123,34,115,470,224,416,12,17,0.277,0.329,0.463,0.79271401685581,1334,0.186,0.538461538461538,29,41.3793103448276,3103,834,0.32935868514341,0.4633553317124,25.0347826086957
"T Pham","CF",880,2966,505,771,137,18,115,366,408,817,98,29,0.26,0.355,0.435,0.784028913339524,1289,0.175,0.499388004895961,127,77.1653543307087,3374,871,0.349436870183758,0.434592043155765,25.7913043478261
"L Valbuena","3B",1011,3148,377,710,169,9,114,367,374,788,11,16,0.226,0.31,0.394,0.701362898087678,1239,0.168,0.474619289340102,27,40.7407407407407,3522,744,0.307779670641681,0.393583227445997,27.6140350877193
"R Belliard","2B",1484,5045,685,1377,328,24,114,601,488,797,43,28,0.273,0.338,0.415,0.752331134375833,2095,0.142,0.612296110414053,71,60.5633802816901,5533,1286,0.337068498102295,0.415262636273538,44.2543859649123
"W Lockman","1B",1666,5940,836,1658,222,49,114,563,552,383,43,27,0.279,0.342,0.391,0.730991367775102,2320,0.112,1.44125326370757,70,61.4285714285714,6492,1399,0.340418977202711,0.390572390572391,52.1052631578947
"T Shaw","3B",733,2374,310,563,127,3,114,366,275,650,20,4,0.237,0.319,0.437,0.753582522119743,1038,0.2,0.423076923076923,24,83.3333333333333,2649,676,0.316345790864477,0.437236731255265,20.8245614035088
"B Fullmer","DH",807,2789,395,778,203,16,114,442,216,373,32,21,0.279,0.336,0.486,0.816619247590815,1355,0.207,0.579088471849866,53,60.377358490566,3005,837,0.330782029950083,0.485837217640731,24.4649122807018
"D Freese","3B",1184,3758,481,1041,197,7,113,535,370,974,8,11,0.277,0.351,0.423,0.765175506722609,1591,0.146,0.379876796714579,19,42.1052631578947,4128,1016,0.341812015503876,0.423363491218733,33.2566371681416
"P Waner","RF",2550,9459,1627,3152,605,191,113,1309,1091,376,104,0,0.333,0.404,0.473,0.87559166049135,4478,0.14,2.90159574468085,104,100,10550,2936,0.40218009478673,0.47341156570462,83.7079646017699
"T Munson","C",1423,5344,696,1558,229,32,113,701,438,571,48,50,0.292,0.346,0.41,0.755014659370294,2190,0.118,0.76707530647986,98,48.9795918367347,5782,1397,0.345209270148737,0.409805389221557,47.2920353982301
"L O'Doul","LF",970,3264,624,1140,175,41,113,542,333,122,36,0,0.349,0.413,0.532,0.94137066836743,1736,0.183,2.72950819672131,36,100,3597,1166,0.409507923269391,0.531862745098039,28.8849557522124
"R Furcal","SS",1614,6477,1063,1817,311,69,113,587,643,910,314,94,0.281,0.346,0.402,0.747697990989725,2605,0.121,0.706593406593407,408,76.9607843137255,7120,1650,0.345505617977528,0.402192373012197,57.3185840707965
"T Kennedy","C",1491,4979,474,1313,244,12,113,628,365,855,6,15,0.264,0.314,0.386,0.699616608317809,1920,0.122,0.426900584795322,21,28.5714285714286,5344,1102,0.313997005988024,0.385619602329785,44.0619469026549
"C Hinton","LF",1354,3968,518,1048,152,47,113,443,416,685,130,50,0.264,0.332,0.412,0.745483944549094,1633,0.148,0.607299270072993,180,72.2222222222222,4384,961,0.333941605839416,0.411542338709677,35.1150442477876
"F Tatis","3B",949,3051,427,807,174,14,113,448,321,709,50,21,0.265,0.344,0.442,0.776341926280515,1348,0.177,0.452750352609309,71,70.4225352112676,3372,875,0.334519572953737,0.441822353326778,27
"G Walker","1B",855,2864,368,746,164,19,113,444,268,520,19,12,0.26,0.326,0.449,0.773126297651919,1287,0.189,0.515384615384615,31,61.2903225806452,3132,812,0.323754789272031,0.449371508379888,25.3451327433628
"J Cirillo","3B",1617,5396,800,1598,343,21,112,727,563,694,63,37,0.296,0.366,0.43,0.792407526299991,2319,0.134,0.811239193083574,100,63,5959,1527,0.362644739050176,0.429762787249815,48.1785714285714
"J Morrison","3B",1089,3375,371,876,170,16,112,435,213,521,50,37,0.26,0.305,0.419,0.722474668648582,1414,0.159,0.408829174664108,87,57.4712643678161,3588,806,0.303511705685619,0.418962962962963,30.1339285714286
"D Hollins","3B",983,3346,578,870,166,17,112,482,464,687,47,27,0.26,0.358,0.42,0.770334461330409,1406,0.16,0.675400291120815,74,63.5135135135135,3810,1060,0.350131233595801,0.420203227734608,29.875
"G McDougald","2B",1336,4676,697,1291,187,51,112,576,559,623,45,44,0.276,0.356,0.41,0.763142564645576,1916,0.134,0.897271268057785,89,50.561797752809,5235,1273,0.353390639923591,0.409751924721985,41.75
"M Haniger","RF",564,2164,344,565,109,10,112,323,217,583,18,6,0.261,0.335,0.476,0.804403856470006,1030,0.215,0.37221269296741,24,75,2381,667,0.328433431331373,0.475970425138632,19.3214285714286
"S Alomar","C",1377,4530,520,1236,249,10,112,588,212,499,25,24,0.273,0.309,0.406,0.711758155713399,1841,0.133,0.424849699398798,49,51.0204081632653,4742,1108,0.305356389708984,0.406401766004415,40.4464285714286
"C Speier","SS",2260,7156,770,1759,302,50,112,720,847,988,42,54,0.246,0.327,0.349,0.67456584370576,2497,0.103,0.857287449392713,96,43.75,8003,1490,0.325627889541422,0.348937954164338,63.8928571428571
"J Brandt","CF",1221,3895,540,1020,175,37,112,485,351,574,45,30,0.262,0.323,0.412,0.734958886019433,1605,0.15,0.611498257839721,75,60,4246,1025,0.322892133772963,0.41206675224647,34.7767857142857
"C Blefary","LF",974,2947,394,699,104,20,112,382,456,444,24,24,0.237,0.342,0.4,0.739474271738314,1179,0.163,1.02702702702703,48,50,3403,776,0.339406406112254,0.40006786562606,26.3125
"M Alvis","3B",1014,3629,421,895,142,22,111,373,262,662,43,46,0.247,0.302,0.39,0.686991884600755,1414,0.143,0.395770392749245,89,48.314606741573,3891,794,0.297352865587253,0.389639019013502,32.6936936936937
"G Gagne","SS",1798,5673,712,1440,296,50,111,604,367,1121,108,96,0.254,0.302,0.382,0.681509573056059,2169,0.128,0.327386262265834,204,52.9411764705882,6040,1316,0.299172185430464,0.382337387625595,51.1081081081081
"R Cullenbine","RF",1181,3879,627,1072,209,32,110,599,853,399,26,20,0.276,0.408,0.432,0.838617056491409,1675,0.156,2.13784461152882,46,56.5217391304348,4732,1226,0.406804733727811,0.431812322763599,35.2636363636364
"D Peralta","LF",1011,3568,444,1004,202,47,110,487,295,766,33,16,0.281,0.339,0.457,0.793105714905932,1630,0.176,0.385117493472585,49,67.3469387755102,3863,931,0.33626714988351,0.456838565022422,32.4363636363636
"M Ensberg","3B",731,2204,340,579,102,10,110,347,332,436,22,19,0.263,0.362,0.468,0.827012973257685,1031,0.205,0.761467889908257,41,53.6585365853659,2536,687,0.359227129337539,0.467785843920145,20.0363636363636
"R Winn","CF",1717,6186,863,1759,367,59,110,662,526,1010,215,84,0.284,0.343,0.416,0.756535914655223,2574,0.132,0.520792079207921,299,71.9063545150502,6712,1525,0.340435041716329,0.416100872938894,56.2363636363636
"W Aikens","1B",774,2492,301,675,125,2,110,415,319,444,3,6,0.271,0.354,0.455,0.808666994431987,1134,0.184,0.718468468468468,9,33.3333333333333,2811,716,0.353610814656706,0.455056179775281,22.6545454545455
"G Brock","1B",1013,3202,420,794,141,6,110,462,434,469,41,18,0.248,0.338,0.399,0.73654701510126,1277,0.151,0.925373134328358,59,69.4915254237288,3636,882,0.337733773377338,0.398813241723923,29.1090909090909
"J Saltalamacchia","C",895,2852,377,662,161,6,110,381,304,984,5,7,0.232,0.306,0.408,0.7145689236824,1165,0.176,0.308943089430894,12,41.6666666666667,3156,758,0.306083650190114,0.408485273492286,25.9272727272727
"H Manush","LF",2009,7654,1288,2524,491,160,110,1183,506,345,114,58,0.33,0.377,0.479,0.850158125701286,3665,0.149,1.46666666666667,172,66.2790697674419,8160,2471,0.371323529411765,0.478834596289522,69.5818181818182
"J Hammonds","RF",957,3032,475,824,172,17,110,423,292,596,67,30,0.272,0.338,0.449,0.784288884867074,1360,0.177,0.48993288590604,97,69.0721649484536,3324,898,0.335740072202166,0.448548812664908,27.5636363636364
"R Clayton","SS",2108,7379,935,1904,363,55,110,723,565,1415,231,100,0.258,0.312,0.367,0.677652481177703,2707,0.109,0.399293286219081,331,69.7885196374622,7944,1658,0.310800604229607,0.366851876948096,67.0818181818182
"D Duncan","C",929,2885,274,617,79,4,109,341,252,677,5,14,0.214,0.279,0.357,0.634381942146318,1031,0.143,0.372230428360414,19,26.3157894736842,3137,615,0.277016257570928,0.35736568457539,26.4678899082569
"F Galvis","SS",1102,3921,436,966,171,27,109,426,241,853,57,21,0.246,0.292,0.387,0.677150941571775,1518,0.141,0.28253223915592,78,73.0769230769231,4162,862,0.290004805382028,0.387146136189748,35.9724770642202
"E Byrnes","LF",963,3202,482,827,191,30,109,396,253,538,129,23,0.258,0.32,0.439,0.751378705964344,1405,0.181,0.470260223048327,152,84.8684210526316,3455,878,0.312590448625181,0.438788257339163,29.3761467889908
"D Young","LF",1118,4108,473,1162,218,11,109,566,179,784,36,21,0.283,0.316,0.421,0.733692234101921,1729,0.138,0.228316326530612,57,63.1578947368421,4287,1039,0.312806158152554,0.420886075949367,37.6880733944954
"J Aguilar","1B",762,2254,280,574,105,2,109,393,228,595,1,1,0.255,0.324,0.448,0.771218791268741,1010,0.193,0.383193277310924,2,50,2482,673,0.323126510878324,0.448092280390417,20.6788990825688
"P Garner","2B",1860,6136,780,1594,299,82,109,738,564,842,225,105,0.26,0.323,0.389,0.710616279748584,2384,0.129,0.669833729216152,330,68.1818181818182,6700,1518,0.322089552238806,0.388526727509778,56.2935779816514
"S Hillenbrand","3B",943,3570,463,1014,202,15,108,490,140,464,16,12,0.284,0.321,0.44,0.750827123302151,1570,0.156,0.301724137931034,28,57.1428571428571,3710,953,0.311051212938005,0.439775910364146,33.0555555555556
"A Cowens","RF",1584,5534,704,1494,276,68,108,717,389,659,120,75,0.27,0.319,0.403,0.720876718025893,2230,0.133,0.590288315629742,195,61.5384615384615,5923,1421,0.317913219652203,0.40296349837369,51.2407407407407
"J Bradley","CF",1140,3633,505,825,199,27,108,443,357,1037,69,18,0.227,0.306,0.386,0.682147565445405,1402,0.159,0.344262295081967,87,79.3103448275862,3990,948,0.296240601503759,0.385906963941646,33.6388888888889
"G Matthews","CF",1281,4103,612,1056,225,29,108,484,454,849,95,36,0.257,0.332,0.405,0.736671535265573,1663,0.148,0.534746760895171,131,72.5190839694656,4557,1096,0.33135834979153,0.405313185474043,37.9907407407407
"J Lucroy","C",1210,4140,483,1134,217,24,108,548,369,662,30,9,0.274,0.335,0.416,0.74951690821256,1723,0.142,0.557401812688822,39,76.9230769230769,4509,1031,0.333333333333333,0.416183574879227,38.3333333333333
"J Loney","1B",1443,5023,528,1425,267,21,108,669,397,652,38,21,0.284,0.336,0.41,0.745877671199567,2058,0.126,0.608895705521472,59,64.4067796610169,5420,1197,0.336162361623616,0.409715309575951,46.5092592592593
"J Howell","3B",941,2639,345,632,129,16,108,337,300,626,14,15,0.239,0.318,0.423,0.740381053635621,1117,0.184,0.479233226837061,29,48.2758620689655,2939,682,0.31711466485199,0.42326638878363,24.4351851851852
"S Victorino","CF",1299,4630,731,1274,231,70,108,489,381,626,231,46,0.275,0.34,0.425,0.755543376924977,1969,0.15,0.608626198083067,277,83.3935018050541,5011,1220,0.330273398523249,0.425269978401728,42.8703703703704
"C Martinez","LF",1003,2906,350,713,134,7,108,424,404,528,10,16,0.245,0.337,0.408,0.74523924872594,1185,0.163,0.765151515151515,26,38.4615384615385,3310,774,0.337462235649547,0.407777013076394,26.9074074074074
"G Selkirk","RF",846,2790,503,810,131,41,108,576,486,319,49,32,0.29,0.4,0.483,0.878400094529127,1347,0.193,1.52351097178683,81,60.4938271604938,3276,1079,0.395604395604396,0.482795698924731,25.8333333333333
"R Northey","RF",1084,3172,385,874,172,28,108,513,361,297,7,0,0.276,0.352,0.45,0.799119917449206,1426,0.174,1.21548821548822,7,100,3533,898,0.349561279365978,0.449558638083228,29.3703703703704
"J Dykes","3B",2283,8046,1108,2256,453,90,108,1071,958,850,70,55,0.28,0.365,0.399,0.75628132463126,3213,0.119,1.12705882352941,125,56,9004,2179,0.356952465570857,0.399328859060403,74.5
"G Soto","C",797,2522,308,619,146,4,108,361,311,673,3,5,0.245,0.33,0.435,0.76324615882878,1097,0.19,0.462109955423477,8,37.5,2833,669,0.328273914578186,0.434972244250595,23.3518518518519
"F Whitfield","1B",817,2284,242,578,93,8,108,356,139,371,7,16,0.253,0.298,0.443,0.738558639367474,1011,0.19,0.37466307277628,23,30.4347826086957,2423,598,0.295914156004953,0.442644483362522,21.1481481481481
"D Litwhiler","LF",1057,3494,428,982,162,32,107,451,299,377,11,0,0.281,0.342,0.438,0.775334719411274,1529,0.157,0.793103448275862,11,100,3793,879,0.337727392565252,0.437607326846022,32.6542056074766
"T Pe?a","C",1988,6489,667,1687,298,27,107,708,455,846,80,63,0.26,0.309,0.364,0.672160144462838,2360,0.104,0.537825059101655,143,55.9440559440559,6944,1375,0.308467741935484,0.363692402527354,60.6448598130841
"D LeMahieu","2B",1427,5314,810,1578,249,36,107,582,483,858,91,46,0.297,0.356,0.418,0.773293117687896,2220,0.121,0.562937062937063,137,66.4233576642336,5797,1392,0.355528721752631,0.417764395935265,49.6635514018692
"T Walker","2B",1288,4554,647,1316,284,30,107,545,421,571,66,37,0.289,0.348,0.435,0.784147924514977,1981,0.146,0.737302977232925,103,64.0776699029126,4975,1192,0.349145728643216,0.435002195871761,42.5607476635514
"M Gonzalez","SS",1139,3526,420,888,183,8,107,415,261,812,44,28,0.252,0.31,0.399,0.702725732313175,1408,0.147,0.321428571428571,72,61.1111111111111,3787,835,0.303406390282546,0.39931934203063,32.9532710280374
"L Herndon","LF",1537,4877,605,1334,186,76,107,550,353,793,92,56,0.274,0.322,0.409,0.731215001856374,1993,0.135,0.445145018915511,148,62.1621621621622,5230,1155,0.322562141491396,0.408652860364978,45.5794392523364
"J Segura","3B",1331,5206,712,1480,232,45,107,492,302,782,205,71,0.284,0.33,0.408,0.731328105579535,2123,0.124,0.38618925831202,276,74.2753623188406,5508,1204,0.323529411764706,0.407798693814829,48.6542056074766
"M Tiernan","OF",1476,5906,1313,1835,256,162,106,851,747,318,428,0,0.311,0.392,0.463,0.850845341992738,2733,0.152,2.34905660377358,428,100,6653,2164,0.388095595971742,0.462749746020996,55.7169811320755
"S Hairston","LF",923,2431,300,589,133,17,106,313,175,577,36,11,0.242,0.296,0.442,0.734963109212579,1074,0.2,0.303292894280763,47,76.5957446808511,2606,613,0.293169608595549,0.44179350061703,22.9339622641509
"D Ross","C",883,2280,254,521,116,5,106,314,287,735,3,5,0.229,0.316,0.423,0.738009930357643,965,0.194,0.39047619047619,8,37.5,2567,568,0.314764316322556,0.423245614035088,21.5094339622642
"R Repulski","LF",928,3088,407,830,153,23,106,416,207,433,25,29,0.269,0.319,0.436,0.750923934836107,1347,0.167,0.478060046189376,54,46.2962962962963,3295,823,0.314719271623672,0.436204663212435,29.1320754716981
"B Campbell","RF",1360,4762,759,1382,295,87,106,766,548,584,53,50,0.29,0.367,0.455,0.818946050457522,2169,0.165,0.938356164383562,103,51.4563106796116,5310,1525,0.36346516007533,0.455480890382192,44.9245283018868
"F Reyes","OF",531,1828,232,457,73,4,106,278,170,616,6,2,0.25,0.313,0.468,0.782085148605936,856,0.218,0.275974025974026,8,75,1998,510,0.313813813813814,0.468271334792123,17.2452830188679
"H Duffy","CF",113,7042,1552,2292,325,119,106,1302,662,211,574,0,0.325,0.386,0.449,0.834019396453205,3173,0.124,3.13744075829384,574,100,7704,2854,0.38343717549325,0.450582220959955,66.4339622641509
"L Thomas","OF",1027,3324,405,847,111,22,106,428,332,397,25,11,0.255,0.327,0.397,0.719595501978845,1320,0.142,0.836272040302267,36,69.4444444444444,3656,833,0.322483588621444,0.397111913357401,31.3584905660377
"R Hansen","SS",1384,4311,446,1007,156,17,106,501,551,643,9,14,0.234,0.32,0.351,0.671870844780092,1515,0.117,0.856920684292379,23,39.1304347826087,4862,947,0.320444261620732,0.35142658315936,40.6698113207547
"W Kurowski","3B",916,3229,518,925,162,32,106,529,369,332,19,0,0.286,0.366,0.455,0.814583856590091,1469,0.169,1.11144578313253,19,100,3598,1047,0.35964424680378,0.454939609786312,30.4622641509434
"D Brouthers","1B",2,6711,1523,2296,460,205,106,1296,840,238,256,0,0.342,0.423,0.519,0.934456898573236,3484,0.177,3.52941176470588,256,100,7551,2819,0.415309230565488,0.519147668007748,63.311320754717
"R Brogna","1B",848,2958,379,795,176,13,106,458,227,655,32,16,0.269,0.32,0.445,0.765436254077228,1315,0.176,0.346564885496183,48,66.6666666666667,3185,837,0.320879120879121,0.444557133198107,27.9056603773585
"T Plouffe","3B",830,2933,364,710,155,10,106,379,246,676,12,11,0.242,0.304,0.41,0.710883743437773,1203,0.168,0.363905325443787,23,52.1739130434783,3179,743,0.300723497955332,0.410160245482441,27.6698113207547
"S Hatteberg","1B",1314,4226,538,1153,249,7,106,527,562,503,3,8,0.273,0.361,0.41,0.768504219216601,1734,0.137,1.11729622266402,11,27.2727272727273,4788,1065,0.358187134502924,0.410317084713677,39.8679245283019
"I Meusel","LF",1290,4900,701,1521,250,93,106,819,269,199,113,53,0.31,0.348,0.464,0.810580935798579,2275,0.154,1.35175879396985,166,68.0722891566265,5169,1520,0.346295221512865,0.464285714285714,46.2264150943396
"F Bolling","2B",1540,5562,692,1415,221,40,106,556,462,558,40,38,0.254,0.313,0.366,0.677282778272025,2034,0.112,0.827956989247312,78,51.2820512820513,6024,1248,0.311586985391766,0.365695792880259,52.4716981132075
"B Cerv","LF",829,2261,320,624,96,26,105,374,212,392,12,10,0.276,0.34,0.481,0.818811675605607,1087,0.205,0.540816326530612,22,54.5454545454545,2473,694,0.338050950262839,0.480760725342769,21.5333333333333
"M Devereaux","CF",1086,3740,491,949,170,33,105,480,296,635,86,56,0.254,0.308,0.401,0.709543255089224,1500,0.147,0.466141732283465,142,60.5633802816901,4036,971,0.308473736372646,0.401069518716578,35.6190476190476
"M Ellis","2B",1435,5117,690,1343,257,25,105,550,438,801,82,29,0.262,0.327,0.384,0.704626131950697,1965,0.122,0.546816479400749,111,73.8738738738739,5555,1240,0.320612061206121,0.384014070744577,48.7333333333333
"D Spencer","SS",1098,3689,457,901,145,20,105,428,449,516,13,7,0.244,0.327,0.38,0.706022280129252,1401,0.136,0.87015503875969,20,65,4138,885,0.326244562590624,0.379777717538628,35.1333333333333
"D Nilsson","C",837,2779,389,789,157,10,105,470,320,424,15,18,0.284,0.356,0.461,0.818814552187551,1281,0.177,0.754716981132076,33,45.4545454545455,3099,859,0.357857373346241,0.46095717884131,26.4666666666667
"G Grantham","2B",1445,4989,912,1508,292,93,105,712,717,526,132,53,0.302,0.392,0.461,0.851155085878733,2301,0.159,1.36311787072243,185,71.3513513513514,5706,1624,0.38994041359972,0.461214672279014,47.5142857142857
"D Walker","RF",1906,6740,1037,2064,376,96,105,1023,817,325,59,10,0.306,0.383,0.437,0.818476296270991,2947,0.131,2.51384615384615,69,85.5072463768116,7557,2060,0.381235940187905,0.437240356083086,64.1904761904762
"A Avila","C",1052,3060,352,714,155,9,105,397,528,1068,8,8,0.233,0.348,0.393,0.738964303670186,1202,0.16,0.49438202247191,16,50,3588,749,0.346153846153846,0.39281045751634,29.1428571428571
"J Cust","DH",670,2107,311,510,96,2,105,323,444,819,6,6,0.242,0.374,0.439,0.812983806196031,925,0.197,0.542124542124542,12,50,2551,634,0.373970991767934,0.439012814428097,20.0666666666667
"F Frisch","2B",2311,9112,1532,2880,466,138,105,1244,728,272,419,74,0.316,0.369,0.432,0.798734269827334,3937,0.116,2.67647058823529,493,84.9898580121704,9840,2776,0.366666666666667,0.432067603160667,86.7809523809524
"M Morse","LF",832,2569,296,705,139,8,105,355,178,668,6,6,0.274,0.331,0.457,0.778817983679567,1175,0.183,0.266467065868263,12,50,2747,651,0.321441572624681,0.457376411054885,24.4666666666667
"M Whiten","RF",940,3104,465,804,129,20,105,423,378,712,78,40,0.259,0.341,0.415,0.754408534021803,1288,0.156,0.530898876404494,118,66.1016949152542,3482,888,0.339460080413555,0.414948453608247,29.5619047619048
"B Boone","C",2264,7245,679,1838,303,26,105,826,663,608,38,50,0.254,0.315,0.346,0.662431785407968,2508,0.092,1.09046052631579,88,43.1818181818182,7908,1505,0.316262013151239,0.346169772256729,69
"I Happ","LF",681,2135,308,533,116,10,105,309,278,708,37,17,0.25,0.34,0.461,0.796986075618891,984,0.211,0.392655367231638,54,68.5185185185185,2413,617,0.336096145876502,0.460889929742389,20.3333333333333
"J Ellsbury","CF",1235,4846,749,1376,241,47,104,512,399,737,343,71,0.284,0.342,0.417,0.755875237584524,2023,0.133,0.541383989145183,414,82.8502415458937,5245,1261,0.338417540514776,0.417457697069748,46.5961538461538
"X Nady","RF",961,2969,365,797,159,7,104,410,189,626,19,8,0.268,0.323,0.432,0.744018143147333,1282,0.164,0.301916932907348,27,70.3703703703704,3158,775,0.31222292590247,0.431795217244864,28.5480769230769
"J Piersall","CF",1734,5890,811,1604,256,52,104,591,524,583,115,57,0.272,0.332,0.386,0.718191900887437,2276,0.114,0.898799313893654,172,66.8604651162791,6414,1402,0.331774243841596,0.38641765704584,56.6346153846154
"J Roseboro","C",1585,4847,512,1206,190,44,104,548,547,677,67,56,0.249,0.326,0.371,0.695529207849937,1796,0.122,0.807976366322009,123,54.4715447154472,5394,1060,0.324990730441231,0.370538477408706,46.6057692307692
"V Guerrero Jr.","1B",507,1937,300,550,104,5,104,313,213,356,13,5,0.284,0.358,0.504,0.858755687889448,976,0.22,0.598314606741573,18,72.2222222222222,2150,613,0.354883720930233,0.503871966959215,18.625
"I Calderon","RF",924,3312,470,901,200,25,104,444,306,556,97,49,0.272,0.333,0.442,0.775336782272214,1463,0.17,0.550359712230216,146,66.4383561643836,3618,914,0.333609729132117,0.441727053140097,31.8461538461538
"F Stubbs","1B",945,2591,323,602,109,12,104,348,260,626,74,28,0.232,0.303,0.404,0.706441137136468,1047,0.172,0.415335463258786,102,72.5490196078431,2851,671,0.302350052613118,0.40409108452335,24.9134615384615
"D Murphy","LF",1110,3467,440,950,203,16,104,472,316,575,54,28,0.274,0.333,0.432,0.766440440935459,1497,0.158,0.549565217391304,82,65.8536585365854,3783,912,0.334655035685963,0.431785405249495,33.3365384615385
"E Battey","C",1141,3586,393,969,150,17,104,449,421,470,13,12,0.27,0.349,0.409,0.755426121966425,1465,0.139,0.895744680851064,25,52,4007,842,0.346892937359621,0.408533184606804,34.4807692307692
"K Daniels","LF",727,2338,391,666,125,8,104,360,365,493,87,26,0.285,0.382,0.479,0.860042243086366,1119,0.194,0.740365111561866,113,76.9911504424779,2703,751,0.381428042915279,0.478614200171086,22.4807692307692
"P Polanco","2B",1927,7214,1009,2142,348,32,104,723,429,538,81,30,0.297,0.343,0.397,0.73366929648657,2866,0.1,0.797397769516729,111,72.972972972973,7643,1732,0.336386235771294,0.397283060715276,69.3653846153846
"J Cantu","1B",847,3128,367,847,203,5,104,476,189,559,11,4,0.271,0.316,0.439,0.750949344884563,1372,0.168,0.338103756708408,15,73.3333333333333,3317,843,0.312330419053361,0.438618925831202,30.0769230769231
"J Tabor","3B",1005,3788,473,1021,191,29,104,598,286,377,69,54,0.27,0.322,0.418,0.738449559599365,1582,0.148,0.758620689655172,123,56.0975609756098,4074,1071,0.320814923907707,0.417634635691658,36.4230769230769
"G Hamner","SS",1531,5839,711,1529,272,62,104,708,351,432,35,14,0.262,0.303,0.383,0.6868292172764,2237,0.121,0.8125,49,71.4285714285714,6190,1419,0.303715670436187,0.383113546840212,56.1442307692308
"R Doumit","C",980,3093,350,818,191,7,104,413,232,621,12,6,0.264,0.324,0.432,0.747409260299147,1335,0.168,0.373590982286634,18,66.6666666666667,3325,763,0.315789473684211,0.431619786614937,29.7403846153846
"O Merced","RF",1391,3998,564,1108,229,28,103,585,487,661,57,29,0.277,0.355,0.426,0.781342733797222,1702,0.149,0.736762481089259,86,66.2790697674419,4485,1149,0.355629877369008,0.425712856428214,38.8155339805825
"F Lindstrom","3B",1439,5611,895,1747,301,81,103,779,334,276,84,10,0.311,0.351,0.449,0.798981635106698,2519,0.138,1.21014492753623,94,89.3617021276596,5945,1674,0.350042052144659,0.448939582962039,54.4757281553398
"B Skinner","LF",1381,4318,642,1198,197,58,103,531,485,646,67,36,0.277,0.351,0.421,0.771897427470499,1820,0.144,0.75077399380805,103,65.0485436893204,4803,1173,0.350405996252342,0.421491431218157,41.9223300970874
"T Gonzalez","CF",1559,5195,690,1485,238,57,103,615,467,706,79,61,0.286,0.35,0.413,0.757844012852344,2146,0.127,0.661473087818697,140,56.4285714285714,5662,1305,0.344754503708937,0.413089509143407,50.4368932038835
"D Gernert","1B",835,2493,357,632,104,8,103,402,363,462,10,11,0.254,0.351,0.426,0.773981012380885,1061,0.172,0.785714285714286,21,47.6190476190476,2856,759,0.348389355742297,0.425591656638588,24.2038834951456
"B McRae","CF",1354,5114,734,1336,264,58,103,532,488,824,196,86,0.261,0.331,0.396,0.721569842716377,2025,0.135,0.592233009708738,282,69.5035460992908,5602,1266,0.325598000714031,0.395971842002346,49.6504854368932
"R Jackson","3B",955,3203,412,835,115,44,103,415,281,382,36,16,0.261,0.32,0.421,0.740864710287034,1347,0.16,0.735602094240838,52,69.2307692307692,3484,827,0.320321469575201,0.420543240711833,31.0970873786408
"M Canha","LF",790,2619,420,650,132,13,103,357,306,650,32,10,0.248,0.349,0.426,0.753336270449672,1117,0.178,0.470769230769231,42,76.1904761904762,2925,777,0.326837606837607,0.426498663612066,25.4271844660194
"J Johnstone","RF",1748,4703,578,1254,215,38,102,531,429,632,50,54,0.267,0.329,0.394,0.721520889553425,1851,0.127,0.67879746835443,104,48.0769230769231,5132,1109,0.327942322681216,0.393578566872209,46.1078431372549
"S Yeager","C",1268,3584,357,816,118,16,102,410,342,726,14,18,0.228,0.298,0.355,0.649867413215923,1272,0.127,0.471074380165289,32,43.75,3926,767,0.294956698930209,0.354910714285714,35.1372549019608
"G Sisler","1B",2054,8267,1282,2810,425,164,102,1175,472,327,375,127,0.34,0.379,0.468,0.843563166512961,3869,0.128,1.4434250764526,502,74.7011952191235,8739,2457,0.375557844146928,0.468005322366034,81.0490196078431
"L Piniella","LF",1747,5867,651,1705,305,41,102,766,368,541,32,41,0.291,0.333,0.409,0.741204723960652,2398,0.118,0.680221811460259,73,43.8356164383562,6235,1417,0.332477947072975,0.408726776887677,57.5196078431373
"O Brown","RF",1221,3642,404,964,144,11,102,454,314,616,30,27,0.265,0.324,0.394,0.717342441763295,1436,0.129,0.50974025974026,57,52.6315789473684,3956,858,0.323053589484328,0.394288852278968,35.7058823529412
"P DeJong","SS",617,2154,300,501,107,4,102,306,192,628,19,9,0.233,0.306,0.428,0.723437273662038,922,0.195,0.305732484076433,28,67.8571428571429,2346,606,0.29539641943734,0.428040854224698,21.1176470588235
"J Oliver","C",1076,3367,320,831,174,3,102,476,248,637,13,13,0.247,0.299,0.391,0.689627952698492,1317,0.144,0.389324960753532,26,50,3615,796,0.298478561549101,0.391149391149391,33.0098039215686
"E Soderholm","3B",894,2894,402,764,120,14,102,383,295,359,18,21,0.264,0.335,0.421,0.752949788741231,1218,0.157,0.821727019498607,39,46.1538461538462,3189,785,0.332079021636877,0.420870767104354,28.3725490196078
"D Swanson","SS",830,3055,435,782,162,13,102,413,291,820,58,23,0.256,0.322,0.418,0.738357351719766,1276,0.162,0.354878048780488,81,71.6049382716049,3346,848,0.32068141063957,0.417675941080196,29.9509803921569
"D Menke","SS",1598,5071,605,1270,225,40,101,606,698,853,34,54,0.25,0.343,0.37,0.711474800936427,1878,0.12,0.818288393903869,88,38.6363636363636,5769,1211,0.341133645345814,0.370341155590613,50.2079207920792
"D Dellucci","RF",1099,2873,431,736,141,35,101,398,322,714,41,25,0.256,0.338,0.435,0.766227686729885,1250,0.179,0.450980392156863,66,62.1212121212121,3195,829,0.331142410015649,0.435085276714236,28.4455445544554
"W Moryn","RF",785,2506,324,667,116,16,101,354,251,393,7,7,0.266,0.335,0.446,0.779099909944099,1118,0.18,0.638676844783715,14,50,2757,678,0.332970620239391,0.446129289704709,24.8118811881188
"G Berroa","DH",779,2506,379,692,113,9,101,382,276,510,19,16,0.276,0.349,0.449,0.797272742398832,1126,0.173,0.541176470588235,35,54.2857142857143,2782,761,0.347951114306254,0.449321628092578,24.8118811881188
"E Delahanty","LF",304,7505,1599,2596,522,185,101,1464,741,244,455,0,0.346,0.411,0.505,0.909810970873488,3791,0.159,3.03688524590164,455,100,8246,3063,0.404681057482416,0.505129913391073,74.3069306930693
"G Altman","RF",991,3091,409,832,132,34,101,403,268,572,52,22,0.269,0.329,0.432,0.759377477987596,1335,0.163,0.468531468531469,74,70.2702702702703,3359,812,0.327478416195296,0.4318990617923,30.6039603960396
"D Concepcion","SS",2488,8723,993,2326,389,48,101,950,736,1186,321,109,0.267,0.322,0.357,0.680700141073556,3114,0.09,0.620573355817875,430,74.6511627906977,9459,1943,0.323712866053494,0.356987275020062,86.3663366336634
"H Wagner","SS",2302,10430,1736,3430,640,252,101,1732,963,327,722,15,0.329,0.392,0.466,0.853181121879434,4877,0.137,2.94495412844037,737,97.9647218453189,11393,3468,0.385587641534275,0.467593480345158,103.267326732673
"H Leiber","CF",813,2805,410,808,137,24,101,518,274,319,5,0,0.288,0.356,0.462,0.813444881923953,1296,0.174,0.858934169278997,5,100,3079,928,0.351412796362455,0.462032085561497,27.7722772277228
"J Villar","2B",1032,3530,482,899,161,19,101,343,344,1045,239,66,0.255,0.322,0.397,0.717740848044858,1401,0.142,0.329186602870813,305,78.3606557377049,3874,825,0.32085699535364,0.396883852691218,34.950495049505
"C Curtis","CF",1204,4017,648,1061,195,16,101,461,510,676,212,98,0.264,0.349,0.396,0.74309565394126,1591,0.132,0.754437869822485,310,68.3870967741936,4527,1109,0.347028937486194,0.396066716455066,39.7722772277228
"N McLouth","CF",1045,3257,521,803,191,19,101,333,366,639,133,24,0.247,0.332,0.41,0.732547176886726,1335,0.163,0.572769953051643,157,84.7133757961784,3623,854,0.322660778360475,0.409886398526251,32.2475247524753
"A Galan","LF",1742,5937,1004,1706,336,74,100,830,979,393,123,0,0.287,0.39,0.419,0.807633930124023,2490,0.132,2.4910941475827,123,100,6916,1834,0.38823019086177,0.419403739262254,59.37
"D Sims","C",843,2422,263,580,80,6,100,310,338,483,6,16,0.239,0.34,0.401,0.733929917782645,972,0.162,0.699792960662526,22,27.2727272727273,2760,573,0.332608695652174,0.401321222130471,24.22
"M Prado","3B",1458,5373,664,1542,316,27,100,609,385,676,40,28,0.287,0.335,0.412,0.746352884151115,2212,0.125,0.569526627218935,68,58.8235294117647,5758,1273,0.334664814171587,0.411688069979527,53.73
"M DeRosa","3B",1241,3633,538,975,196,12,100,494,358,707,23,18,0.268,0.34,0.412,0.745507146102126,1495,0.144,0.506364922206506,41,56.0975609756098,3991,1032,0.334001503382611,0.411505642719516,36.33
"R Velarde","2B",1273,4244,633,1171,214,23,100,445,463,853,78,37,0.276,0.352,0.408,0.755012487668015,1731,0.132,0.542790152403283,115,67.8260869565217,4707,1078,0.34714255364351,0.407869934024505,42.44
"M Jacobs","1B",569,1949,248,493,116,6,100,312,170,492,5,2,0.253,0.313,0.473,0.785433461237004,921,0.22,0.345528455284553,7,71.4285714285714,2119,560,0.312883435582822,0.472550025654182,19.49
"A Hicks","LF",871,2810,419,648,111,14,100,351,413,702,65,26,0.231,0.33,0.387,0.716029141082279,1087,0.156,0.588319088319088,91,71.4285714285714,3223,770,0.329196400868756,0.386832740213523,28.1
"J Kruk","1B",1200,3897,582,1170,199,34,100,592,649,701,58,31,0.3,0.397,0.446,0.845859466840884,1737,0.146,0.925820256776034,89,65.1685393258427,4546,1174,0.400131984161901,0.445727482678984,38.97
"Y Alonso","1B",1072,3362,391,872,181,2,100,426,366,648,22,8,0.259,0.332,0.404,0.735710337449863,1357,0.145,0.564814814814815,30,73.3333333333333,3728,817,0.332081545064378,0.403628792385485,33.62
"B Bochte","1B",1538,5233,643,1478,250,21,100,658,653,662,43,41,0.282,0.36,0.396,0.757612128368812,2070,0.114,0.986404833836858,84,51.1904761904762,5886,1301,0.362045531770302,0.395566596598509,52.33
"G Blum","3B",1389,3966,446,990,206,15,99,479,332,667,19,19,0.25,0.31,0.384,0.691599043240274,1523,0.134,0.497751124437781,38,50,4298,925,0.307584923220102,0.384014120020171,40.0606060606061
"C Wilson","1B",698,2010,303,527,100,14,99,292,198,643,14,7,0.262,0.353,0.474,0.801983290071382,952,0.212,0.307931570762053,21,66.6666666666667,2208,595,0.328351449275362,0.47363184079602,20.3030303030303
"G Atkins","3B",817,2928,399,835,169,7,99,488,291,449,8,4,0.285,0.35,0.449,0.798910095793928,1315,0.164,0.648106904231626,12,66.6666666666667,3219,887,0.349798073936005,0.449112021857923,29.5757575757576
"D DeJesus","CF",1472,5220,740,1434,288,65,99,573,510,838,66,62,0.275,0.349,0.412,0.750952839461596,2149,0.137,0.608591885441527,128,51.5625,5730,1313,0.339267015706806,0.411685823754789,52.7272727272727
"J Grubb","CF",1424,4154,553,1153,207,29,99,475,566,558,27,33,0.278,0.366,0.413,0.777049994695739,1715,0.135,1.01433691756272,60,45,4720,1028,0.364194915254237,0.412855079441502,41.959595959596
"M Irvin","LF",764,2499,366,731,97,31,99,443,351,220,28,7,0.293,0.383,0.475,0.854639118805417,1187,0.182,1.59545454545455,35,80,2850,809,0.379649122807018,0.474989995998399,25.2424242424242
"C Paquette","3B",814,2591,304,620,128,10,99,376,120,620,27,13,0.239,0.274,0.411,0.684000215825259,1065,0.172,0.193548387096774,40,67.5,2711,680,0.272962006639616,0.411038209185643,26.1717171717172
"Y Alvarez","LF",371,1339,251,398,91,3,99,288,181,350,2,1,0.297,0.385,0.591,0.972407236350772,792,0.294,0.517142857142857,3,66.6666666666667,1520,539,0.380921052631579,0.591486183719193,13.5252525252525
"G Torres","2B",579,2108,293,558,100,2,99,312,203,513,38,15,0.265,0.331,0.455,0.784228263966493,959,0.19,0.395711500974659,53,71.6981132075472,2311,605,0.329294677628732,0.454933586337761,21.2929292929293
"G Wilson","RF",1201,4151,451,1098,209,26,98,521,253,672,27,25,0.265,0.306,0.398,0.704983872877004,1653,0.133,0.376488095238095,52,51.9230769230769,4404,972,0.306766575840145,0.398217297036859,42.3571428571429
"F Crosetti","SS",1683,6277,1006,1541,260,65,98,649,792,799,113,62,0.245,0.341,0.354,0.68450123166323,2225,0.109,0.991239048811014,175,64.5714285714286,7069,1655,0.330032536426652,0.354468695236578,64.0510204081633
"O Virgil","C",739,2258,258,549,84,6,98,307,248,453,4,5,0.243,0.324,0.416,0.733891450598281,939,0.173,0.547461368653422,9,44.4444444444444,2506,565,0.31803671189146,0.41585473870682,23.0408163265306
"C Knoblauch","2B",1632,6366,1132,1839,322,64,98,615,804,730,407,117,0.289,0.378,0.406,0.774368539981623,2583,0.117,1.1013698630137,524,77.6717557251908,7170,1747,0.368619246861925,0.405749293119698,64.9591836734694
"O Albies","2B",627,2502,401,678,153,25,98,347,180,469,63,18,0.271,0.322,0.47,0.789534815100939,1175,0.199,0.383795309168444,81,77.7777777777778,2682,748,0.319910514541387,0.469624300559552,25.530612244898
"T Hollandsworth","LF",1118,3191,451,871,192,22,98,401,262,701,75,43,0.273,0.328,0.439,0.767167795538476,1401,0.166,0.373751783166904,118,63.5593220338983,3453,852,0.328120474949319,0.439047320589157,32.5612244897959
"H Evers","LF",1142,3801,556,1055,187,41,98,565,415,420,45,36,0.278,0.353,0.426,0.774349180056981,1618,0.148,0.988095238095238,81,55.5555555555556,4216,1121,0.348671726755218,0.425677453301763,38.7857142857143
"L Smith","LF",1613,5170,909,1488,273,58,98,533,623,849,370,140,0.288,0.371,0.42,0.784327947322537,2171,0.132,0.733804475853946,510,72.5490196078431,5793,1442,0.364405316761609,0.419922630560928,52.7551020408163
"M Barrett","C",1054,3512,398,925,220,21,98,424,279,480,11,17,0.263,0.32,0.422,0.739291341019283,1481,0.159,0.58125,28,39.2857142857143,3791,822,0.317594302294909,0.421697038724374,35.8367346938776
"G Coleman","1B",773,2384,282,650,102,11,98,387,177,333,9,8,0.273,0.324,0.448,0.770907311269455,1068,0.175,0.531531531531532,17,52.9411764705882,2561,669,0.322920734088247,0.447986577181208,24.3265306122449
"W Castillo","C",726,2462,251,626,126,1,98,339,183,691,5,0,0.254,0.313,0.426,0.731530300261518,1048,0.172,0.264833574529667,5,100,2645,590,0.30586011342155,0.425670186839967,25.1224489795918
"G Colbrunn","1B",992,2769,337,801,155,12,98,422,170,444,29,21,0.289,0.338,0.46,0.790478381232159,1274,0.171,0.382882882882883,50,58,2939,759,0.330384484518544,0.460093896713615,28.2551020408163
"J Polanco","2B",752,2854,405,772,163,20,98,399,269,553,47,29,0.27,0.334,0.445,0.777972436346648,1269,0.175,0.486437613019892,76,61.8421052631579,3123,804,0.333333333333333,0.444639103013315,29.1224489795918
"P Ward","3B",973,3060,345,776,136,17,98,427,371,539,20,17,0.254,0.339,0.405,0.739533625555536,1240,0.151,0.688311688311688,37,54.0540540540541,3431,772,0.334304867385602,0.405228758169935,31.2244897959184
"D Espinosa","2B",872,2910,367,644,139,12,98,316,242,943,64,24,0.221,0.297,0.378,0.659441886022293,1101,0.157,0.256627783669141,88,72.7272727272727,3152,683,0.281091370558376,0.378350515463918,29.6938775510204
"B Hobson","3B",738,2556,314,634,107,23,98,396,183,569,11,9,0.248,0.297,0.423,0.721210492846332,1081,0.175,0.321616871704745,20,55,2739,710,0.298284045271997,0.422926447574335,26.0816326530612
"B Buxton","CF",588,1968,318,483,114,21,98,255,139,625,77,10,0.245,0.302,0.474,0.769291820528552,933,0.229,0.2224,87,88.5057471264368,2107,573,0.295206454674893,0.474085365853659,20.0816326530612
"T d'Arnaud","C",714,2471,305,626,129,6,97,354,194,528,2,1,0.253,0.313,0.428,0.73585904180805,1058,0.175,0.367424242424242,3,66.6666666666667,2665,659,0.307692307692308,0.428166734115743,25.4742268041237
"B Roberts","2B",1417,5531,850,1527,367,39,97,542,609,844,285,73,0.276,0.347,0.409,0.757031172243859,2263,0.133,0.721563981042654,358,79.608938547486,6140,1392,0.347882736156352,0.409148436087507,57.020618556701
"F Gutierrez","CF",954,3032,394,778,150,9,97,361,228,736,78,19,0.257,0.311,0.408,0.716570487398223,1237,0.151,0.309782608695652,97,80.4123711340206,3260,755,0.308588957055215,0.407981530343008,31.2577319587629
"S Crawford","RF",2385,9570,1391,2961,458,309,97,1525,760,104,366,30,0.309,0.362,0.452,0.81245957589717,4328,0.143,7.30769230769231,396,92.4242424242424,10330,2916,0.360212971926428,0.452246603970742,98.659793814433
"K Hern?ndez","SS",920,2669,387,640,153,15,99,335,280,600,13,5,0.24,0.315,0.42,0.731602980657438,1120,0.18,0.466666666666667,18,72.2222222222222,2949,722,0.31197015937606,0.419632821281379,26.959595959596
"T d'Arnaud","C",714,2471,305,626,129,6,97,354,194,528,2,1,0.253,0.313,0.428,0.73585904180805,1058,0.175,0.367424242424242,3,66.6666666666667,2665,659,0.307692307692308,0.428166734115743,25.4742268041237
"B Roberts","2B",1417,5531,850,1527,367,39,97,542,609,844,285,73,0.276,0.347,0.409,0.757031172243859,2263,0.133,0.721563981042654,358,79.608938547486,6140,1392,0.347882736156352,0.409148436087507,57.020618556701
"S Crawford","RF",2385,9570,1391,2961,458,309,97,1525,760,104,366,30,0.309,0.362,0.452,0.81245957589717,4328,0.143,7.30769230769231,396,92.4242424242424,10330,2916,0.360212971926428,0.452246603970742,98.659793814433
"K Pillar","LF",1033,3607,460,934,217,15,97,391,154,640,92,32,0.259,0.296,0.408,0.69738013480391,1472,0.149,0.240625,124,74.1935483870968,3761,851,0.289284764690242,0.408095370113668,37.1855670103093
"J Castro","C",952,2981,368,678,166,9,97,325,347,970,6,2,0.227,0.312,0.387,0.694775747200217,1153,0.16,0.357731958762887,8,75,3328,693,0.307992788461538,0.386782958738678,30.7319587628866
"C Anson","1B",2276,9101,1719,3011,528,124,97,1879,952,294,247,0,0.331,0.396,0.446,0.842293311660702,4078,0.115,3.23809523809524,247,100,10053,3598,0.394210683378096,0.448082628282606,93.8247422680412
"J Vander Wal","RF",1372,2751,374,717,170,18,97,430,385,698,38,20,0.261,0.351,0.441,0.792697136106351,1214,0.18,0.551575931232092,58,65.5172413793103,3136,804,0.35140306122449,0.441294074881861,28.360824742268
"F Gutierrez","CF",954,3032,394,778,150,9,97,361,228,736,78,19,0.257,0.311,0.408,0.716570487398223,1237,0.151,0.309782608695652,97,80.4123711340206,3260,755,0.308588957055215,0.407981530343008,31.2577319587629
"W Westrum","C",920,2322,302,503,59,8,96,315,489,514,10,5,0.217,0.356,0.373,0.725853673782492,866,0.156,0.95136186770428,15,66.6666666666667,2811,617,0.352899324083956,0.372954349698536,24.1875
"B Carbo","RF",1010,2733,372,722,140,9,96,358,538,611,26,18,0.264,0.387,0.427,0.812572493107387,1168,0.163,0.880523731587561,44,59.0909090909091,3271,730,0.385203301742586,0.427369191364801,28.46875
"H Baker","3B",1575,5984,887,1838,315,103,96,987,473,182,235,28,0.307,0.363,0.442,0.800252405050606,2647,0.135,2.5989010989011,263,89.3536121673004,6457,1874,0.357906148366114,0.442346256684492,62.3333333333333
"G Polanco","RF",823,2883,399,696,156,19,96,362,287,694,98,27,0.241,0.309,0.409,0.718696787761609,1178,0.168,0.413544668587896,125,78.4,3170,761,0.310094637223975,0.408602150537634,30.03125
"D Valencia","3B",865,2963,360,795,154,12,96,397,217,651,11,16,0.268,0.317,0.426,0.743821173933439,1261,0.158,0.333333333333333,27,40.7407407407407,3180,757,0.318238993710692,0.425582180222747,30.8645833333333
"J LaRue","C",922,2719,307,628,148,7,96,348,237,760,14,11,0.231,0.315,0.396,0.68909445932771,1078,0.165,0.311842105263158,25,56,2956,655,0.292625169147497,0.396469290180213,28.3229166666667
"E Andrus","2B",1952,7417,1019,1999,360,50,96,731,586,1138,336,111,0.27,0.325,0.37,0.693369250384416,2747,0.1,0.51493848857645,447,75.1677852348993,8003,1750,0.32300387354742,0.370365376836996,77.2604166666667
"R Dempsey","C",1766,4692,525,1093,223,12,96,471,592,736,20,19,0.233,0.319,0.347,0.665860778699131,1628,0.114,0.804347826086957,39,51.2820512820513,5284,996,0.31888720666162,0.346973572037511,48.875
"A Vaughan","SS",1817,6622,1175,2103,356,128,96,926,937,276,118,0,0.318,0.406,0.453,0.85565797124635,3003,0.135,3.39492753623188,118,100,7559,2101,0.402169599153327,0.453488372093023,68.9791666666667
"M Maldonado","C",1005,2960,317,618,117,4,96,325,260,861,3,5,0.209,0.286,0.348,0.620981618264227,1031,0.139,0.301974448315912,8,37.5,3220,642,0.272670807453416,0.348310810810811,30.8333333333333
"R Karkovice","C",939,2597,336,574,120,6,96,335,233,749,24,14,0.221,0.289,0.383,0.667908336746259,994,0.162,0.311081441922563,38,63.1578947368421,2830,671,0.285159010600707,0.382749326145553,27.0520833333333
"E Thames","1B",605,1868,286,451,100,17,96,235,207,617,18,6,0.241,0.325,0.467,0.784453187482263,873,0.226,0.3354943273906,24,75,2075,521,0.31710843373494,0.467344753747323,19.4583333333333
"D May","CF",1252,3670,462,920,130,20,96,422,344,500,60,47,0.251,0.318,0.375,0.690374696735812,1378,0.124,0.688,107,56.0747663551402,4014,884,0.314897857498754,0.375476839237057,38.2291666666667
"J Mabry","LF",1322,3409,382,898,183,6,96,446,284,717,7,12,0.263,0.322,0.405,0.725169123925081,1381,0.142,0.396094839609484,19,36.8421052631579,3693,828,0.320064987814785,0.405104136110296,35.5104166666667
"R Bush","RF",1219,3045,388,763,154,26,96,409,348,505,33,29,0.251,0.334,0.413,0.740246726453623,1257,0.162,0.689108910891089,62,53.2258064516129,3393,797,0.327438844680224,0.412807881773399,31.71875
"L Voit","1B",487,1616,242,410,69,2,95,272,188,525,1,1,0.254,0.341,0.475,0.806733112335624,768,0.221,0.358095238095238,2,50,1804,514,0.331485587583149,0.475247524752475,17.0105263157895
"N Johnson","1B",832,2698,430,723,173,5,95,398,522,572,29,24,0.268,0.399,0.441,0.828084065030918,1191,0.173,0.912587412587413,53,54.7169811320755,3220,828,0.386645962732919,0.441438102297999,28.4
"S Spence","OF",1112,3871,541,1090,196,60,95,575,520,248,21,23,0.282,0.369,0.437,0.803497101731242,1691,0.155,2.09677419354839,44,47.7272727272727,4391,1116,0.366659075381462,0.43683802634978,40.7473684210526
"J Sundberg","C",1962,6021,621,1493,243,36,95,624,699,963,20,37,0.248,0.327,0.348,0.673807151161411,2093,0.1,0.725856697819315,57,35.0877192982456,6720,1245,0.326190476190476,0.347616674970935,63.3789473684211
"I Goodman","RF",1108,3928,609,1104,188,85,95,525,382,380,49,0,0.281,0.352,0.445,0.789535183181253,1747,0.164,1.00526315789474,49,100,4310,1134,0.344779582366589,0.444755600814664,41.3473684210526
"R Chirinos","C",714,2124,275,480,114,5,95,306,231,664,5,4,0.226,0.319,0.419,0.720460733863519,889,0.193,0.34789156626506,9,55.5555555555556,2355,581,0.301910828025478,0.418549905838041,22.3578947368421
"M Jorgensen","1B",1633,3421,429,833,132,13,95,426,532,589,58,44,0.243,0.347,0.373,0.718297715195346,1276,0.13,0.903225806451613,102,56.8627450980392,3953,855,0.345307361497597,0.372990353697749,36.0105263157895
"P Cavarretta","1B",2030,6754,990,1977,347,99,95,920,820,598,65,0,0.293,0.372,0.416,0.784895242276013,2807,0.123,1.37123745819398,65,100,7574,1910,0.369289675204648,0.415605567071365,71.0947368421053
"J Morales","RF",1441,4528,516,1173,199,36,95,570,366,567,37,57,0.259,0.313,0.382,0.696312983663562,1729,0.123,0.645502645502645,94,39.3617021276596,4894,1086,0.314466693910911,0.38184628975265,47.6631578947368
"Z Versalles","SS",1400,5141,650,1246,230,63,95,471,318,810,97,48,0.242,0.29,0.367,0.653548571072456,1887,0.125,0.392592592592593,145,66.8965517241379,5459,1121,0.286499358856934,0.367049212215522,54.1157894736842
"B Oliver","1B",847,2914,293,745,102,19,94,419,156,562,17,14,0.256,0.295,0.4,0.693965781278295,1167,0.144,0.277580071174377,31,54.8387096774194,3070,712,0.293485342019544,0.400480439258751,31
"T Fernandez","SS",2158,7911,1057,2276,414,92,94,844,690,784,246,138,0.288,0.347,0.399,0.743781810168646,3156,0.111,0.880102040816326,384,64.0625,8601,1901,0.344843622834554,0.398938187334092,84.1595744680851
"L Maye","LF",1288,4048,533,1109,190,39,94,419,282,481,59,34,0.274,0.323,0.41,0.731079128974249,1659,0.136,0.586278586278586,93,63.4408602150538,4330,952,0.321247113163972,0.409832015810277,43.063829787234
"E Taubensee","C",975,2874,351,784,151,9,94,419,255,574,11,10,0.273,0.331,0.43,0.76176965300699,1235,0.157,0.444250871080139,21,52.3809523809524,3129,770,0.332054969638862,0.429714683368128,30.5744680851064
"F Pfeffer","2B",1670,6555,1094,1678,231,119,94,1019,527,498,382,0,0.256,0.313,0.369,0.681909552068598,2429,0.113,1.05823293172691,382,100,7082,2113,0.311352725218865,0.370556826849733,69.7340425531915
"B Bruton","CF",1610,6056,937,1651,241,102,94,545,482,793,207,89,0.273,0.328,0.393,0.71891498658589,2378,0.12,0.6078184110971,296,69.9324324324324,6538,1482,0.326246558580606,0.392668428005284,64.4255319148936
"Y Gurriel","1B",803,3053,400,868,206,5,94,435,188,372,23,9,0.284,0.328,0.447,0.773254121140525,1366,0.163,0.505376344086022,32,71.875,3241,835,0.325825362542425,0.4474287585981,32.4787234042553
"E Bressoud","SS",1186,3672,443,925,184,40,94,365,359,723,9,13,0.252,0.319,0.401,0.719130510331424,1471,0.149,0.496542185338866,22,40.9090909090909,4031,808,0.318531381791119,0.400599128540305,39.063829787234
"W Adames","SS",574,2079,303,530,110,3,94,283,205,649,25,15,0.255,0.322,0.446,0.768172299258114,928,0.191,0.315870570107858,40,62.5,2284,586,0.321803852889667,0.446368446368446,22.1170212765957
"T Cuccinello","2B",1704,6184,730,1729,334,46,94,884,579,497,42,3,0.28,0.343,0.394,0.735350168397829,2437,0.114,1.16498993963783,45,93.3333333333333,6763,1614,0.341268667750998,0.394081500646831,65.7872340425532
"G Wright","SS",1119,4153,584,1219,203,76,94,723,209,407,38,13,0.294,0.328,0.447,0.774278615978705,1856,0.153,0.513513513513513,51,74.5098039215686,4362,1307,0.327372764786795,0.446905851191909,44.1808510638298
"J Lamb","LF",706,2262,329,533,111,22,94,339,293,676,18,12,0.236,0.327,0.429,0.752111720746581,970,0.193,0.433431952662722,30,60,2555,668,0.323287671232877,0.428824049513705,24.063829787234
"L Sheets","DH",748,2284,273,607,98,5,94,339,175,351,6,12,0.266,0.321,0.437,0.75453033960098,997,0.171,0.498575498575499,18,33.3333333333333,2459,612,0.318015453436356,0.436514886164623,24.2978723404255
"L Salazar","3B",1302,4101,438,1070,144,33,94,455,179,653,117,51,0.261,0.293,0.381,0.672705141440314,1562,0.12,0.274119448698315,168,69.6428571428571,4280,893,0.291822429906542,0.380882711533772,43.6276595744681
"E Durazo","1B",624,1948,333,547,108,6,94,330,307,428,7,5,0.281,0.381,0.487,0.86588029339319,949,0.206,0.717289719626168,12,58.3333333333333,2255,663,0.378713968957871,0.487166324435318,20.7234042553191
"O Hudson","2B",1345,4825,648,1319,256,66,93,542,483,825,85,28,0.273,0.341,0.412,0.751093783554787,1986,0.139,0.585454545454545,113,75.2212389380531,5308,1190,0.339487565938207,0.41160621761658,51.8817204301075
"D Buford","LF",1286,4553,718,1203,157,44,93,418,672,575,200,105,0.264,0.362,0.379,0.738162019468734,1727,0.115,1.16869565217391,305,65.5737704918033,5225,1136,0.358851674641148,0.379310344827586,48.9569892473118
"L Mazzilli","CF",1475,4124,571,1068,191,24,93,460,642,627,197,90,0.259,0.359,0.385,0.743369518896581,1586,0.126,1.02392344497608,287,68.6411149825784,4766,1031,0.358791439362149,0.384578079534433,44.3440860215054
"G Oliver","C",786,2216,268,546,111,5,93,320,215,420,24,21,0.246,0.315,0.427,0.739935208134401,946,0.181,0.511904761904762,45,53.3333333333333,2431,588,0.313039901275195,0.426895306859206,23.8279569892473
"J Logan","SS",1503,5244,651,1407,216,41,93,547,451,472,19,13,0.268,0.33,0.378,0.704588244669773,1984,0.11,0.955508474576271,32,59.375,5695,1198,0.326251097453907,0.378337147215866,56.3870967741936
"B Daubach","1B",661,2025,271,525,139,10,93,333,236,541,5,3,0.259,0.341,0.476,0.812132291513096,963,0.217,0.436229205175601,8,62.5,2261,604,0.336576735957541,0.475555555555556,21.7741935483871
"L Easter","1B",491,1725,256,472,54,12,93,340,174,293,1,8,0.274,0.35,0.481,0.82075875174577,829,0.207,0.593856655290102,9,11.1111111111111,1899,596,0.340179041600843,0.480579710144928,18.5483870967742
"C Jones","LF",1213,4263,565,1196,183,33,93,524,360,702,91,48,0.281,0.339,0.404,0.740988019544903,1724,0.123,0.512820512820513,139,65.4676258992806,4623,1089,0.336577979666883,0.40441003987802,45.8387096774194
"S Piscotty","RF",726,2517,322,643,142,9,93,354,225,623,23,12,0.255,0.324,0.43,0.746434094981261,1082,0.175,0.36115569823435,35,65.7142857142857,2742,676,0.316557257476295,0.429876837504966,27.0645161290323
"R Raburn","LF",947,2472,340,626,147,13,93,358,210,683,16,10,0.253,0.316,0.436,0.74779182323002,1078,0.183,0.307467057101025,26,61.5384615384615,2682,698,0.311707680835198,0.436084142394822,26.5806451612903
"N Hundley","C",974,3097,319,766,169,20,93,376,219,810,15,18,0.247,0.299,0.405,0.701952607546974,1254,0.158,0.27037037037037,33,45.4545454545455,3316,695,0.297044632086852,0.404907975460123,33.3010752688172
"P Whitney","3B",1539,5765,696,1701,303,56,93,927,400,438,45,0,0.295,0.343,0.415,0.75623279726571,2395,0.12,0.91324200913242,45,100,6165,1623,0.340794809407948,0.415437987857762,61.989247311828
"J Landis","CF",1346,4288,625,1061,169,50,93,467,588,767,139,51,0.247,0.344,0.375,0.713420247511418,1609,0.128,0.766623207301173,190,73.1578947368421,4876,1092,0.338187038556194,0.375233208955224,46.1075268817204
"J Bour","1B",559,1714,206,433,71,2,92,303,218,447,3,0,0.253,0.337,0.457,0.794366090000507,784,0.204,0.487695749440716,3,100,1932,509,0.33695652173913,0.457409568261377,18.6304347826087
"R Carew","1B",2469,9315,1424,3053,445,112,92,1015,1018,1028,353,187,0.328,0.393,0.429,0.823180665689751,3998,0.101,0.990272373540856,540,65.3703703703704,10333,2439,0.39398045098229,0.429200214707461,101.25
"F Schulte","LF",1807,6533,906,1766,288,124,92,792,545,515,233,17,0.27,0.332,0.395,0.721116632332462,2578,0.125,1.05825242718447,250,93.2,7078,1698,0.326504662333993,0.394611969998469,71.0108695652174
"J Lopez","2B",1036,3841,421,1005,215,11,92,480,150,471,25,17,0.262,0.292,0.395,0.684610733431658,1518,0.133,0.318471337579618,42,59.5238095238095,3991,901,0.289401152593335,0.395209580838323,41.75
"D Stubbs","CF",911,2834,444,687,106,20,92,283,277,972,161,34,0.242,0.313,0.391,0.701187899063741,1109,0.149,0.284979423868313,195,82.5641025641026,3111,727,0.309868209578914,0.391319689484827,30.804347826087
"R Coomer","1B",911,3019,333,827,151,8,92,449,177,429,13,7,0.274,0.313,0.421,0.734811774074997,1270,0.147,0.412587412587413,20,65,3196,782,0.314142678347935,0.420669095727062,32.8152173913044
"J Hegan","C",1666,4772,550,1087,187,46,92,525,456,742,15,24,0.228,0.295,0.344,0.63923207360457,1642,0.116,0.61455525606469,39,38.4615384615385,5228,1075,0.295141545524101,0.344090528080469,51.8695652173913
"D Zimmer","3B",1095,3283,353,773,130,22,91,352,246,678,45,25,0.235,0.29,0.372,0.660361685307595,1220,0.137,0.36283185840708,70,64.2857142857143,3529,705,0.288750354207991,0.371611331099604,36.0769230769231
"G Hatton","3B",1312,4206,562,1068,166,33,91,533,646,430,42,9,0.254,0.354,0.374,0.72724592787205,1573,0.12,1.50232558139535,51,82.3529411764706,4852,1095,0.35325638911789,0.373989538754161,46.2197802197802
"B Virdon","CF",1583,5980,735,1596,237,81,91,502,442,647,47,54,0.267,0.316,0.379,0.696610835037168,2268,0.112,0.683153013910355,101,46.5346534653465,6422,1237,0.317346620990346,0.379264214046823,65.7142857142857
"H Long","SS",350,7673,1456,2128,342,97,91,1055,612,261,536,0,0.277,0.335,0.383,0.713488919953114,2937,0.106,2.3448275862069,536,100,8285,2511,0.330718165359083,0.382770754594031,84.3186813186813
"S Pearce","1B",766,2256,290,572,131,8,91,303,240,509,13,7,0.254,0.332,0.44,0.76503682487725,992,0.186,0.471512770137525,20,65,2496,593,0.325320512820513,0.439716312056738,24.7912087912088
"G Harper","RF",1074,3398,505,1030,158,43,91,528,389,208,58,34,0.303,0.38,0.455,0.829970735670946,1547,0.152,1.87019230769231,92,63.0434782608696,3787,1033,0.374702931080011,0.455267804590936,37.3406593406593
"D Martinez","RF",1919,5795,795,1599,238,72,91,580,567,893,183,94,0.276,0.341,0.389,0.729414971713791,2254,0.113,0.634938409854423,277,66.0649819494585,6362,1375,0.340458975165042,0.388955996548749,63.6813186813187
"C Gaston","CF",1026,3120,314,799,106,30,91,387,185,693,14,7,0.256,0.298,0.397,0.694525582838745,1238,0.141,0.266955266955267,21,66.6666666666667,3305,701,0.297730711043873,0.396794871794872,34.2857142857143
"P Plantier","LF",610,1883,260,457,90,3,91,292,237,476,13,15,0.243,0.332,0.439,0.766020200603212,826,0.196,0.497899159663866,28,46.4285714285714,2120,552,0.327358490566038,0.438661710037175,20.6923076923077
"M Davis","RF",963,2999,419,778,161,16,91,371,236,537,134,56,0.259,0.313,0.415,0.72825161194896,1244,0.156,0.439478584729981,190,70.5263157894737,3235,790,0.313446676970634,0.414804934978326,32.956043956044
"B Brenly","C",871,2615,321,647,119,7,91,333,318,438,45,38,0.247,0.33,0.403,0.731691525001646,1053,0.156,0.726027397260274,83,54.2168674698795,2933,654,0.329014660756904,0.402676864244742,28.7362637362637
"K Landreaux","CF",1264,4101,522,1099,180,45,91,479,299,421,145,60,0.268,0.317,0.4,0.718117421471481,1642,0.132,0.71021377672209,205,70.7317073170732,4400,1001,0.317727272727273,0.400390148744209,45.0659340659341
"M Bordick","SS",1720,5770,676,1500,257,30,91,626,500,800,96,58,0.26,0.323,0.362,0.68119763723157,2090,0.102,0.625,154,62.3376623376623,6270,1302,0.318979266347687,0.362218370883882,63.4065934065934
"L Lacy","RF",1523,4549,650,1303,207,42,91,458,372,657,185,86,0.286,0.339,0.41,0.75079784445637,1867,0.124,0.5662100456621,271,68.2656826568266,4921,1108,0.340377971956919,0.41041987249945,49.989010989011
"F Lopez","SS",1185,4337,600,1145,219,31,90,439,445,913,124,58,0.264,0.333,0.391,0.723550587009332,1696,0.127,0.487404162102957,182,68.1318681318681,4782,1039,0.332496863237139,0.391053723772193,48.1888888888889
"M Lum","LF",1517,3554,404,877,128,20,90,431,366,506,13,29,0.247,0.319,0.37,0.687097464196708,1315,0.123,0.723320158102767,42,30.952380952381,3920,835,0.317091836734694,0.370005627462015,39.4888888888889
"C James","LF",946,3040,343,794,145,24,90,386,193,490,27,17,0.261,0.307,0.413,0.718776047177951,1257,0.152,0.393877551020408,44,61.3636363636364,3233,729,0.305289205072688,0.413486842105263,33.7777777777778
"C May","LF",1165,4120,545,1127,172,23,90,536,512,565,85,53,0.274,0.357,0.392,0.745833123731911,1615,0.118,0.906194690265487,138,61.5942028985507,4632,1081,0.353842832469775,0.391990291262136,45.7777777777778
"W Pipp","1B",1872,6914,974,1941,311,148,90,997,596,551,125,60,0.281,0.341,0.408,0.745395070577962,2818,0.127,1.08166969147005,185,67.5675675675676,7510,1971,0.337816245006658,0.407578825571305,76.8222222222222
"M Grudzielanek","2B",1802,7052,946,2040,391,36,90,640,364,954,133,52,0.289,0.332,0.393,0.717385750850058,2773,0.104,0.381551362683438,185,71.8918918918919,7416,1586,0.324163969795038,0.39322178105502,78.3555555555556
"G Parra","OF",1519,4858,633,1335,269,42,90,532,318,920,97,55,0.275,0.322,0.403,0.722405099254691,1958,0.128,0.345652173913043,152,63.8157894736842,5176,1165,0.31935857805255,0.403046521202141,53.9777777777778
"J Pagliaroni","C",849,2465,269,622,98,7,90,326,330,494,4,7,0.252,0.344,0.407,0.747910460217645,1004,0.155,0.668016194331984,11,36.3636363636364,2795,595,0.340608228980322,0.407302231237323,27.3888888888889
"S Bream","1B",1088,3108,351,819,191,12,90,455,353,450,50,40,0.264,0.336,0.42,0.758192873188539,1304,0.156,0.784444444444444,90,55.5555555555556,3461,806,0.33863045362612,0.41956241956242,34.5333333333333
"A Ashby","C",1370,4123,397,1010,183,13,90,513,461,622,7,10,0.245,0.32,0.361,0.682043575837076,1489,0.116,0.741157556270096,17,41.1764705882353,4584,910,0.320898778359511,0.361144797477565,45.8111111111111
"G Redus","LF",1159,3513,591,886,183,51,90,352,481,688,322,83,0.252,0.342,0.41,0.752454115274819,1441,0.158,0.699127906976744,405,79.5061728395062,3994,943,0.342263395092639,0.41019072018218,39.0333333333333
"D Ward","1B",948,2234,242,588,131,5,90,379,192,422,1,6,0.263,0.32,0.447,0.768696846532012,999,0.184,0.454976303317536,7,14.2857142857143,2426,621,0.321516900247321,0.447179946284691,24.8222222222222
"W Judnich","CF",790,2786,424,782,150,29,90,420,385,298,20,24,0.281,0.369,0.452,0.820284012303713,1260,0.171,1.29194630872483,44,45.4545454545455,3171,844,0.36802270577105,0.452261306532663,30.9555555555556
"K Greene","SS",736,2567,322,628,157,14,90,352,190,556,25,6,0.245,0.302,0.422,0.718592571460626,1083,0.177,0.341726618705036,31,80.6451612903226,2757,674,0.296699310845122,0.421893260615504,28.5222222222222
"B Chapman","CF",1717,6478,1144,1958,407,107,90,977,824,556,287,135,0.302,0.383,0.44,0.82078774258094,2849,0.138,1.48201438848921,422,68.0094786729858,7302,2121,0.380991509175568,0.439796233405372,71.9777777777778
"Y Escobar","SS",1434,5315,689,1501,258,12,90,519,509,686,34,32,0.282,0.35,0.386,0.731388913297427,2053,0.104,0.74198250728863,66,51.5151515151515,5824,1208,0.345123626373626,0.386265286923801,59.0555555555556
"J Leyritz","C",903,2527,325,667,107,2,90,387,337,581,7,7,0.264,0.362,0.415,0.76527967227684,1048,0.151,0.580034423407917,14,50,2864,712,0.350558659217877,0.414721013058963,28.0777777777778
"K Mench","LF",729,2362,311,632,150,14,89,331,183,335,12,6,0.268,0.324,0.456,0.77620527374324,1077,0.188,0.546268656716418,18,66.6666666666667,2545,642,0.320235756385069,0.455969517358171,26.5393258426966
"R Kress","SS",1392,5087,691,1454,298,58,89,799,474,453,47,56,0.286,0.347,0.42,0.766397501315626,2135,0.134,1.04635761589404,103,45.6310679611651,5561,1490,0.346700233770905,0.419697267544722,57.1573033707865
"N Etten","1B",937,3320,426,921,167,25,89,526,480,199,22,13,0.277,0.371,0.423,0.791876981610653,1405,0.146,2.41206030150754,35,62.8571428571429,3800,952,0.368684210526316,0.423192771084337,37.3033707865169
"C Taylor","LF",863,2808,422,716,171,29,89,353,296,905,68,18,0.255,0.331,0.432,0.757654859458983,1212,0.177,0.32707182320442,86,79.0697674418605,3104,775,0.326030927835052,0.431623931623932,31.5505617977528
"C Barmes","SS",1186,3805,434,932,208,17,89,415,216,734,43,30,0.245,0.294,0.379,0.664213339886751,1441,0.134,0.294277929155313,73,58.9041095890411,4021,849,0.285501119124596,0.378712220762155,42.752808988764
"G Norton","3B",1107,2410,315,600,126,8,89,338,323,604,15,18,0.249,0.339,0.419,0.756396311866795,1009,0.17,0.53476821192053,33,45.4545454545455,2733,653,0.33772411269667,0.418672199170124,27.0786516853933
"W Moses","RF",2014,7356,1124,2138,435,110,89,679,821,457,174,81,0.291,0.364,0.416,0.77785560541534,3060,0.125,1.7964989059081,255,68.2352941176471,8177,1803,0.361868655986303,0.415986949429038,82.6516853932584
"F Mantilla","2B",969,2707,360,707,97,10,89,330,256,352,27,10,0.261,0.329,0.403,0.728037620992612,1091,0.142,0.727272727272727,37,72.972972972973,2963,690,0.325008437394533,0.403029183598079,30.4157303370787
"D Hoak","3B",1263,4322,598,1144,214,44,89,498,523,530,64,47,0.265,0.345,0.396,0.740410332524836,1713,0.131,0.986792452830189,111,57.6576576576577,4845,1096,0.34406604747162,0.396344285053216,48.561797752809
"C Walker","1B",549,1833,270,456,96,5,89,258,201,483,12,4,0.249,0.329,0.452,0.775272897566251,829,0.203,0.416149068322981,16,75,2034,528,0.323008849557522,0.452264048008729,20.5955056179775
"R Gedman","C",1033,3159,331,795,176,12,88,382,236,509,3,4,0.252,0.304,0.399,0.702225728113472,1259,0.147,0.463654223968566,7,42.8571428571429,3395,713,0.303681885125184,0.398543842988287,35.8977272727273
"G Zaun","C",1232,3489,437,878,194,9,88,446,479,544,23,19,0.252,0.344,0.388,0.73006269993713,1354,0.136,0.880514705882353,42,54.7619047619048,3968,883,0.341985887096774,0.388076812840355,39.6477272727273
"D Wilson","C",1299,4186,441,1097,211,13,88,519,280,763,23,14,0.262,0.309,0.382,0.690078287529562,1598,0.12,0.36697247706422,37,62.1621621621622,4466,960,0.30832960143305,0.381748686096512,47.5681818181818
"K Elster","SS",940,2844,332,648,136,12,88,376,295,562,14,11,0.228,0.3,0.377,0.677348040553286,1072,0.149,0.52491103202847,25,56,3139,708,0.300414144632048,0.376933895921238,32.3181818181818
"T Holmes","RF",1320,4992,698,1507,292,47,88,581,480,122,40,0,0.302,0.366,0.432,0.795212691183086,2157,0.13,3.9344262295082,40,100,5472,1279,0.36312134502924,0.432091346153846,56.7272727272727
"D Miller","C",989,3182,361,834,205,4,87,406,303,772,5,5,0.262,0.329,0.411,0.737317605216574,1308,0.149,0.392487046632124,10,50,3485,767,0.326255380200861,0.411062225015713,36.5747126436782
"G Myers","C",1108,3042,333,776,150,7,87,396,268,539,3,12,0.255,0.313,0.395,0.710213903637097,1201,0.14,0.49721706864564,15,20,3310,729,0.315407854984894,0.394806048652202,34.9655172413793
"B Broussard","1B",705,2136,275,561,114,13,87,314,171,466,15,7,0.263,0.324,0.45,0.767669720391773,962,0.187,0.366952789699571,22,68.1818181818182,2307,589,0.317295188556567,0.450374531835206,24.551724137931
"K Kouzmanoff","3B",685,2525,273,650,143,8,87,371,125,500,6,1,0.257,0.302,0.424,0.716215206426303,1070,0.167,0.25,7,85.7142857142857,2650,644,0.292452830188679,0.423762376237624,29.0229885057471
"M Duncan","2B",1279,4677,619,1247,233,37,87,491,201,913,174,57,0.267,0.3,0.388,0.684912243606079,1815,0.121,0.220153340635268,231,75.3246753246753,4878,1110,0.296842968429684,0.388069275176395,53.7586206896552
"D DiMaggio","CF",1399,5640,1046,1680,308,57,87,618,750,571,100,62,0.298,0.383,0.419,0.799253321346519,2363,0.121,1.31348511383538,162,61.7283950617284,6390,1664,0.380281690140845,0.418971631205674,64.8275862068966
"B Diaz","C",993,3274,327,834,162,5,87,452,198,429,9,17,0.255,0.297,0.387,0.68422341644404,1267,0.132,0.461538461538462,26,34.6153846153846,3472,779,0.297235023041475,0.386988393402566,37.632183908046
"J Beckley","1B",784,9526,1600,2930,473,243,87,1575,616,270,315,0,0.308,0.361,0.436,0.785284980983658,4150,0.128,2.28148148148148,315,100,10142,3175,0.349635180437783,0.435649800545874,109.494252873563
"Z Cozart","SS",839,3088,408,764,158,24,87,305,219,549,21,4,0.247,0.3,0.399,0.695888157637042,1231,0.152,0.398907103825137,25,84,3307,713,0.297248261263985,0.398639896373057,35.4942528735632
"L Cain","CF",1171,4314,626,1220,225,24,87,454,362,854,190,44,0.283,0.343,0.407,0.744906570725031,1754,0.124,0.423887587822014,234,81.1965811965812,4676,1080,0.338323353293413,0.406583217431618,49.5862068965517
"C Neal","2B",970,3316,461,858,113,38,87,391,337,557,48,36,0.259,0.329,0.394,0.721579533585595,1308,0.135,0.605026929982047,84,57.1428571428571,3653,852,0.327128387626608,0.394451145958987,38.1149425287356
"D Unser","CF",1799,5215,617,1344,179,42,87,481,481,675,64,60,0.258,0.319,0.358,0.678597788089672,1868,0.1,0.712592592592593,124,51.6129032258064,5696,1098,0.320400280898876,0.358197507190796,59.9425287356322
"S Gennett","2B",793,2704,365,773,149,16,87,360,156,571,24,12,0.286,0.327,0.449,0.774159494351802,1215,0.163,0.273204903677758,36,66.6666666666667,2860,725,0.324825174825175,0.449334319526627,31.0804597701149
"P Mullin","RF",864,2493,381,676,106,43,87,385,330,312,20,27,0.271,0.358,0.453,0.809226514367754,1129,0.182,1.05769230769231,47,42.5531914893617,2823,766,0.356358483882395,0.452868030485359,28.6551724137931
"H Kuenn","SS",1833,6913,951,2092,356,56,87,671,594,404,68,56,0.303,0.357,0.408,0.765871136117501,2821,0.105,1.47029702970297,124,54.8387096774194,7507,1622,0.357799387238577,0.408071748878924,79.4597701149425
"J Wockenfuss","C",795,2072,267,543,73,11,86,310,277,278,5,11,0.262,0.349,0.432,0.781517149333241,896,0.17,0.996402877697842,16,31.25,2349,577,0.349084716900809,0.432432432432432,24.093023255814
"S Andrews","3B",569,1704,196,375,76,4,86,263,191,515,7,10,0.22,0.298,0.421,0.719455386673604,717,0.201,0.370873786407767,17,41.1764705882353,1895,459,0.29868073878628,0.420774647887324,19.8139534883721
"T Flowers","C",802,2456,267,582,111,5,86,301,227,852,2,6,0.237,0.319,0.391,0.692814785092773,961,0.154,0.266431924882629,8,25,2683,568,0.301528140141632,0.39128664495114,28.5581395348837
"P Seerey","LF",561,1815,236,406,73,5,86,261,259,485,3,8,0.224,0.321,0.412,0.732206699235717,747,0.188,0.534020618556701,11,27.2727272727273,2074,497,0.320636451301832,0.411570247933884,21.1046511627907
"M Heath","C",1325,4212,462,1061,173,27,86,469,278,616,54,40,0.252,0.3,0.367,0.665264796519436,1546,0.115,0.451298701298701,94,57.4468085106383,4490,931,0.298218262806236,0.3670465337132,48.9767441860465
"T Teufel","2B",1073,3112,415,789,185,12,86,379,387,531,23,19,0.254,0.336,0.404,0.739694999158775,1256,0.15,0.728813559322034,42,54.7619047619048,3499,794,0.33609602743641,0.403598971722365,36.1860465116279
"D Meyer","1B",1118,3734,411,944,153,31,86,459,219,277,61,29,0.253,0.293,0.379,0.673692737550525,1417,0.126,0.790613718411552,90,67.7777777777778,3953,870,0.294206931444473,0.379485806106052,43.4186046511628
"B Huskey","RF",642,2078,259,555,98,4,86,336,164,384,21,17,0.267,0.318,0.442,0.762947972858689,919,0.175,0.427083333333333,38,55.2631578947368,2242,595,0.320695807314897,0.442252165543792,24.1627906976744
"C Tracy","3B",938,2706,317,741,172,9,86,358,233,473,11,7,0.274,0.333,0.439,0.770799179271449,1189,0.165,0.492600422832981,18,61.1111111111111,2939,675,0.331405239877509,0.439393939393939,31.4651162790698
"B Tolan","OF",1282,4238,572,1121,173,34,86,497,258,587,193,100,0.265,0.314,0.382,0.688972862879321,1620,0.117,0.439522998296422,293,65.8703071672355,4496,1069,0.306717081850534,0.382255781028787,49.2790697674419
"W Crawford","RF",1210,3435,507,921,152,35,86,419,431,664,47,36,0.268,0.349,0.408,0.757575730192903,1401,0.14,0.649096385542169,83,56.6265060240964,3866,926,0.34971546818417,0.407860262008734,39.9418604651163
"T Paciorek","LF",1391,4121,494,1162,232,30,86,503,245,704,55,38,0.282,0.325,0.415,0.737696088201355,1712,0.133,0.348011363636364,93,59.1397849462366,4366,997,0.322262940907009,0.415433147294346,47.9186046511628
"W Greene","3B",655,1902,254,446,76,12,86,307,260,477,17,6,0.234,0.326,0.423,0.749262424965784,804,0.189,0.545073375262054,23,73.9130434782609,2162,561,0.326549491211841,0.422712933753943,22.1162790697674
"J Collins","1B",908,2329,404,596,79,24,86,329,338,263,27,21,0.256,0.35,0.421,0.771417044316433,981,0.165,1.2851711026616,48,56.25,2667,733,0.350206224221972,0.421210820094461,27.0813953488372
"E Charles","3B",1005,3482,438,917,147,30,86,421,332,525,86,35,0.263,0.33,0.397,0.724376047977056,1382,0.134,0.632380952380952,121,71.0743801652893,3814,859,0.327477713686418,0.396898334290638,40.4883720930233
"J Frederick","CF",805,3102,498,954,200,35,85,377,210,176,23,0,0.308,0.357,0.477,0.828238443640849,1479,0.169,1.19318181818182,23,100,3312,875,0.351449275362319,0.47678916827853,36.4941176470588
"C Flood","CF",1759,6357,851,1861,271,44,85,636,444,609,88,73,0.293,0.342,0.389,0.728255338737558,2475,0.096,0.729064039408867,161,54.6583850931677,6801,1487,0.338920746948978,0.38933459178858,74.7882352941176
"E Kirkpatrick","C",1311,3467,411,824,143,18,85,424,456,518,34,39,0.238,0.327,0.363,0.68913063345666,1258,0.125,0.88030888030888,73,46.5753424657534,3923,835,0.326280907468774,0.362849725987886,40.7882352941176
"J Martin","CF",1018,2652,337,666,130,17,85,345,207,574,38,23,0.251,0.307,0.409,0.714476710047971,1085,0.158,0.360627177700348,61,62.2950819672131,2859,682,0.305351521511018,0.409125188536953,31.2
"B Mueller","3B",1216,4223,663,1229,265,22,85,493,543,571,20,18,0.291,0.373,0.425,0.796379934473497,1793,0.134,0.950963222416813,38,52.6315789473684,4766,1156,0.371800251783466,0.424579682690031,49.6823529411765
"G Williams","LF",1168,3059,474,780,183,18,85,365,180,530,106,57,0.255,0.301,0.41,0.70632566220308,1254,0.155,0.339622641509434,163,65.0306748466258,3239,839,0.296387774004322,0.409937888198758,35.9882352941176
"N Mazara","OF",684,2448,294,626,114,9,85,360,197,592,7,6,0.256,0.315,0.414,0.724960308635111,1013,0.158,0.33277027027027,13,53.8461538461538,2645,654,0.311153119092628,0.413807189542484,28.8
"F Luderus","1B",1346,4851,570,1344,251,54,84,642,414,421,55,8,0.277,0.34,0.403,0.736912822627108,1955,0.126,0.983372921615202,63,87.3015873015873,5265,1212,0.333903133903134,0.403009688723974,57.75
"R Knight","3B",1495,4829,490,1311,266,27,84,595,343,579,14,25,0.271,0.321,0.39,0.709734721761105,1883,0.119,0.592400690846287,39,35.8974358974359,5172,1085,0.319798917246713,0.389935804514392,57.4880952380952
"D Dietrich","2B",746,2191,318,536,107,21,84,255,181,576,7,5,0.245,0.335,0.428,0.729935163242546,937,0.183,0.314236111111111,12,58.3333333333333,2372,573,0.302276559865093,0.427658603377453,26.0833333333333
"B Doran","2B",1453,5131,727,1366,220,39,84,497,709,600,209,93,0.266,0.354,0.373,0.728724707192115,1916,0.107,1.18166666666667,302,69.205298013245,5840,1224,0.355308219178082,0.373416488014032,61.0833333333333
"G Brown","LF",1051,2262,330,582,78,19,84,322,242,275,30,8,0.257,0.33,0.42,0.749055798962156,950,0.163,0.88,38,78.9473684210526,2504,652,0.329073482428115,0.419982316534041,26.9285714285714
"W Pe?a","RF",599,1703,211,425,70,5,84,240,111,559,12,8,0.25,0.303,0.445,0.739989291871598,757,0.195,0.198568872987478,20,60,1814,451,0.2954796030871,0.444509688784498,20.2738095238095
"R Davis","3B",612,1980,261,508,108,6,84,276,146,503,16,11,0.257,0.31,0.444,0.752064388000418,880,0.187,0.290258449304175,27,59.2592592592593,2126,537,0.307619943555974,0.444444444444444,23.5714285714286
"B Dahlen","SS",1205,9031,1589,2458,413,163,84,1233,1064,269,547,0,0.272,0.358,0.382,0.730792352509426,3449,0.11,3.95539033457249,547,100,10095,2822,0.34888558692422,0.381906765585207,107.511904761905
"M Lansing","2B",1110,4150,554,1124,254,17,84,440,299,570,119,38,0.271,0.324,0.401,0.720811012086106,1664,0.13,0.524561403508772,157,75.7961783439491,4449,994,0.319847156664419,0.400963855421687,49.4047619047619
"B Lowe","2B",398,1393,223,348,73,8,84,237,164,439,18,2,0.25,0.337,0.495,0.823453444855252,689,0.245,0.373576309794989,20,90,1557,460,0.328837508028259,0.494615936826992,16.5833333333333
"G Suhr","1B",1435,5176,714,1446,288,114,84,818,718,433,53,0,0.279,0.368,0.428,0.794896468207786,2214,0.149,1.65819861431871,53,100,5894,1532,0.367153036986766,0.42774343122102,61.6190476190476
"R Schoendienst","2B",2216,8479,1223,2449,427,78,84,773,606,346,89,27,0.289,0.337,0.387,0.723578398845203,3284,0.098,1.7514450867052,116,76.7241379310345,9085,1996,0.336268574573473,0.38730982427173,100.940476190476
"D Philley","RF",1904,6296,790,1700,276,72,84,729,594,551,101,63,0.27,0.334,0.377,0.709693440025966,2372,0.107,1.07803992740472,164,61.5853658536585,6890,1519,0.332946298984035,0.376747141041931,74.9523809523809
"F Catalanotto","LF",1265,3824,562,1113,262,37,84,457,331,492,45,27,0.291,0.357,0.445,0.792355268391664,1701,0.154,0.672764227642276,72,62.5,4155,1019,0.347533092659446,0.444822175732218,45.5238095238095
"Y Moncada","3B",648,2445,336,622,138,18,84,303,282,807,30,13,0.254,0.335,0.429,0.760129673499047,1048,0.175,0.349442379182156,43,69.7674418604651,2727,639,0.331499816648332,0.428629856850716,29.1071428571429
"J Rivera","RF",1171,3552,503,911,155,56,83,422,365,523,160,70,0.256,0.328,0.402,0.727505005324446,1427,0.146,0.697896749521989,230,69.5652173913043,3917,925,0.325759509828951,0.401745495495495,42.7951807228916
"A Santander","RF",441,1659,212,408,91,3,83,239,113,367,3,6,0.246,0.3,0.454,0.748508715713047,754,0.208,0.307901907356948,9,33.3333333333333,1772,451,0.294018058690745,0.454490657022303,19.9879518072289
"R Jablonski","3B",812,2562,297,687,126,11,83,438,196,330,16,13,0.268,0.32,0.423,0.743266483592688,1084,0.155,0.593939393939394,29,55.1724137931034,2758,735,0.320159535895576,0.423106947697112,30.8674698795181
"B Darwin","RF",646,2224,250,559,76,16,83,328,160,577,15,9,0.251,0.311,0.412,0.713464463328666,916,0.161,0.277296360485269,24,62.5,2384,578,0.301593959731544,0.411870503597122,26.7951807228916
"B Jacobson","OF",1471,5507,788,1714,328,94,83,819,355,410,86,54,0.311,0.357,0.45,0.80310556020107,2479,0.139,0.865853658536585,140,61.4285714285714,5862,1607,0.35295121119072,0.45015434901035,66.3493975903614
"S Magee","LF",2087,7441,1112,2169,425,166,83,1176,736,359,441,12,0.291,0.364,0.427,0.781954728056217,3175,0.136,2.05013927576602,453,97.3509933774834,8177,2288,0.355264767029473,0.426689961026744,89.6506024096386
"D Boston","CF",1058,2629,378,655,131,22,83,278,237,469,98,50,0.249,0.312,0.41,0.721657384739487,1079,0.161,0.505330490405117,148,66.2162162162162,2866,656,0.311235170969993,0.410422213769494,31.6746987951807
"L Aparicio","SS",2601,10230,1335,2677,394,92,83,791,736,742,506,136,0.262,0.311,0.343,0.653756719650126,3504,0.081,0.991913746630728,642,78.816199376947,10966,2126,0.311234725515229,0.342521994134897,123.253012048193
"M Solters","OF",938,3421,503,990,213,42,83,599,221,377,42,23,0.289,0.334,0.449,0.781501133050845,1536,0.16,0.586206896551724,65,64.6153846153846,3642,1102,0.332509610104338,0.448991522946507,41.2168674698795
"K Kiermaier","CF",916,3062,411,760,140,51,82,316,236,737,112,36,0.248,0.308,0.408,0.709577960080313,1248,0.16,0.320217096336499,148,75.6756756756757,3298,727,0.302001212856277,0.407576747224037,37.3414634146341
"G Kapler","CF",1104,2983,443,799,176,16,82,386,269,480,77,30,0.268,0.329,0.42,0.748460216751011,1253,0.152,0.560416666666667,107,71.9626168224299,3252,829,0.328413284132841,0.42004693261817,36.3780487804878
"K Marte","2B",822,2996,415,835,194,32,82,338,271,513,46,14,0.279,0.341,0.447,0.785466122976743,1339,0.168,0.528265107212476,60,76.6666666666667,3267,753,0.338536883991429,0.446929238985314,36.5365853658537
"B Freeman","RF",820,4208,588,1235,199,131,82,713,272,2,92,0,0.293,0.346,0.462,0.797885829712113,1942,0.169,136,92,100,4480,1301,0.336383928571429,0.461501901140684,51.3170731707317
"B Trammell","RF",584,1798,243,469,96,7,82,285,210,325,10,10,0.261,0.339,0.459,0.796990569424194,825,0.198,0.646153846153846,20,50,2008,528,0.338147410358566,0.458843159065629,21.9268292682927
"R Hundley","C",1061,3442,311,813,118,13,82,381,271,565,12,17,0.236,0.292,0.35,0.641453313600643,1203,0.114,0.479646017699115,29,41.3793103448276,3713,692,0.291947212496633,0.349506101104009,41.9756097560976
"R Repoz","CF",831,2145,257,480,73,19,82,260,280,499,26,25,0.224,0.314,0.39,0.70361185206546,837,0.166,0.561122244488978,51,50.9803921568627,2425,517,0.31340206185567,0.39020979020979,26.1585365853659
"E McNair","SS",1251,4519,592,1240,229,29,82,633,261,328,59,54,0.274,0.318,0.392,0.706360175215571,1773,0.118,0.795731707317073,113,52.212389380531,4780,1225,0.314016736401674,0.392343438813897,55.109756097561
"B Dahlgren","1B",1137,4045,471,1056,174,37,82,569,390,401,18,11,0.261,0.329,0.383,0.709231963410504,1550,0.122,0.972568578553616,29,62.0689655172414,4435,1040,0.326042841037204,0.3831891223733,49.3292682926829
"O Infante","2B",1507,5271,609,1427,260,53,82,542,296,776,80,33,0.271,0.308,0.387,0.696336042913806,2039,0.116,0.381443298969072,113,70.7964601769911,5567,1151,0.309502425004491,0.386833617909315,64.280487804878
"S Vogt","C",794,2348,259,560,121,13,82,313,210,491,5,5,0.239,0.301,0.406,0.706893761496484,953,0.167,0.427698574338086,10,50,2558,572,0.301016419077404,0.40587734241908,28.6341463414634
"K Wong","2B",1106,3585,489,933,180,31,82,379,312,636,117,36,0.26,0.334,0.396,0.715850300037686,1421,0.136,0.490566037735849,153,76.4705882352941,3897,868,0.319476520400308,0.396373779637378,43.719512195122
"N Lajoie","2B",1988,9589,1504,3252,657,163,82,1599,516,85,380,21,0.339,0.381,0.466,0.840190998994859,4481,0.127,6.07058823529412,401,94.7630922693267,10105,3103,0.372884710539337,0.467306288455522,116.939024390244
"R McMahon","2B",609,1926,260,469,95,7,82,284,216,604,20,7,0.244,0.323,0.428,0.747624283358203,824,0.184,0.357615894039735,27,74.0740740740741,2142,544,0.319794584500467,0.427829698857736,23.4878048780488
"I Davis","1B",667,2076,260,496,117,2,81,291,294,538,7,8,0.239,0.332,0.414,0.747591522157996,860,0.175,0.546468401486989,15,46.6666666666667,2370,551,0.333333333333333,0.414258188824663,25.6296296296296
"S Berry","3B",860,2413,310,657,153,10,81,369,206,438,47,24,0.272,0.334,0.445,0.774189760915444,1073,0.173,0.470319634703196,71,66.1971830985916,2619,679,0.329515082092402,0.444674678823042,29.7901234567901
"M Ivie","1B",857,2694,309,724,133,17,81,411,214,402,22,16,0.269,0.324,0.421,0.743493871449009,1134,0.152,0.532338308457711,38,57.8947368421053,2908,720,0.322558459422283,0.420935412026726,33.2592592592593
"J Edwards","C",1470,4577,430,1106,202,32,81,524,465,635,15,23,0.242,0.311,0.353,0.664433917860347,1615,0.111,0.732283464566929,38,39.4736842105263,5042,954,0.311582705275684,0.352851212584662,56.5061728395062
"S Rodr?guez","2B",1103,2572,344,580,124,14,81,298,225,775,42,19,0.226,0.301,0.379,0.66689079223407,975,0.153,0.290322580645161,61,68.8524590163934,2797,642,0.287808366106543,0.379082426127527,31.7530864197531
"W Venable","RF",967,2836,378,707,118,39,81,307,254,748,135,31,0.249,0.315,0.404,0.715093504229029,1146,0.155,0.339572192513369,166,81.3253012048193,3090,685,0.311003236245955,0.404090267983075,35.0123456790123
"L Dykstra","CF",1278,4559,802,1298,281,43,81,404,640,503,285,72,0.285,0.375,0.419,0.791276824836943,1908,0.134,1.27236580516899,357,79.8319327731092,5199,1206,0.372763993075591,0.418512831761351,56.2839506172839
"G Crowe","1B",702,1727,215,467,70,12,81,299,159,246,3,2,0.27,0.333,0.466,0.797466597812425,804,0.196,0.646341463414634,5,60,1886,514,0.331919406150583,0.465547191661841,21.320987654321
"J Bateman","C",1017,3330,250,765,123,18,81,375,172,610,10,10,0.23,0.271,0.35,0.618011843939885,1167,0.12,0.281967213114754,20,50,3502,625,0.267561393489435,0.35045045045045,41.1111111111111
"R Wilkins","C",720,2114,280,515,95,7,81,275,278,571,9,12,0.244,0.332,0.41,0.741644728723623,867,0.166,0.486865148861646,21,42.8571428571429,2392,555,0.331521739130435,0.410122989593188,26.0987654320988
"M Saunders","LF",775,2455,324,570,123,19,81,263,255,711,55,23,0.232,0.305,0.397,0.701169388475962,974,0.165,0.358649789029536,78,70.5128205128205,2710,587,0.304428044280443,0.396741344195519,30.3086419753086
"F Tatis Jr.","RF",273,1036,210,303,55,8,81,195,119,324,52,13,0.292,0.369,0.596,0.960927810927811,617,0.304,0.367283950617284,65,80,1155,405,0.365367965367965,0.595559845559846,12.7901234567901
"R Grossman","LF",1014,3339,449,819,174,14,81,371,500,860,63,27,0.245,0.347,0.379,0.722135511074258,1264,0.134,0.581395348837209,90,70,3839,820,0.343579057046106,0.378556454028152,41.2222222222222
"Y Betancourt","SS",1156,4052,437,1057,218,29,80,457,143,435,30,30,0.261,0.285,0.388,0.674258183542435,1573,0.127,0.328735632183908,60,50,4195,894,0.286054827175209,0.388203356367226,50.65
"E Herrmann","C",922,2729,247,654,92,4,80,320,260,361,6,8,0.24,0.31,0.364,0.67002387280294,994,0.124,0.720221606648199,14,42.8571428571429,2989,567,0.305787888926062,0.364235983876878,34.1125
"J Hauser","1B",629,2044,350,580,103,28,80,356,250,229,19,19,0.284,0.368,0.479,0.840776244333469,979,0.195,1.09170305676856,38,50,2294,706,0.361813426329555,0.478962818003914,25.55
"J Lugo","SS",1352,4758,688,1279,238,34,80,475,439,876,198,69,0.269,0.333,0.384,0.714139854831048,1825,0.115,0.501141552511416,267,74.1573033707865,5197,1163,0.330575331922263,0.383564522908785,59.475
"J Youngblood","RF",1408,3659,453,969,180,23,80,422,332,589,60,55,0.265,0.329,0.392,0.718167119528094,1435,0.127,0.563667232597623,115,52.1739130434783,3991,875,0.32598346279128,0.392183656736813,45.7375
"D Jackson","CF",960,2629,311,676,114,15,80,317,131,480,43,17,0.257,0.293,0.403,0.69558643557643,1060,0.146,0.272916666666667,60,71.6666666666667,2760,628,0.292391304347826,0.403195131228604,32.8625
"J Flaherty","C",1047,3372,319,849,176,3,80,395,175,514,10,19,0.252,0.29,0.377,0.665622310936581,1271,0.125,0.340466926070039,29,34.4827586206897,3547,714,0.288694671553425,0.376927639383155,42.15
"M Hargrove","1B",1666,5564,783,1614,266,28,80,686,965,550,24,37,0.29,0.396,0.391,0.786092442290598,2176,0.101,1.75454545454545,61,39.344262295082,6529,1469,0.395006892326543,0.391085549964055,69.55
"O Vizquel","SS",2968,10586,1445,2877,456,77,80,951,1028,1087,404,167,0.272,0.336,0.352,0.688300903705506,3727,0.08,0.945722171113155,571,70.753064798599,11614,2396,0.336232133631824,0.352068770073682,132.325
"J Arencibia","C",467,1573,169,333,67,4,80,245,85,484,2,3,0.212,0.258,0.412,0.664062661759778,648,0.2,0.175619834710744,5,40,1658,414,0.25211097708082,0.411951684678957,19.6625
"S Mele","RF",1046,3437,406,916,168,39,80,544,311,342,15,14,0.267,0.328,0.408,0.735288478168863,1402,0.141,0.909356725146199,29,51.7241379310345,3748,950,0.327374599786553,0.40791387838231,42.9625
"B Avila","2B",1300,4620,725,1296,185,35,80,467,561,399,78,52,0.281,0.359,0.388,0.746087352138308,1791,0.107,1.40601503759399,130,60,5181,1192,0.35842501447597,0.387662337662338,57.75
"R Howell","3B",1112,3791,422,991,183,31,80,454,318,675,9,14,0.261,0.321,0.389,0.707912176107943,1476,0.128,0.471111111111111,23,39.1304347826087,4109,876,0.318568994889267,0.389343181218676,47.3875
"P Lo Duca","C",1082,3892,483,1112,222,8,80,481,266,295,20,19,0.286,0.337,0.409,0.739939650011592,1590,0.123,0.901694915254237,39,51.2820512820513,4158,964,0.331409331409331,0.408530318602261,48.65
"D DeShields","2B",1615,5779,872,1548,244,74,80,561,754,1061,463,147,0.268,0.352,0.377,0.729592810676702,2180,0.109,0.710650329877474,610,75.9016393442623,6533,1433,0.352364916577376,0.377227894099325,72.2375
"B Ausmus","C",1971,6279,718,1579,270,34,80,607,634,1034,102,53,0.251,0.325,0.344,0.66364754937639,2157,0.093,0.613152804642166,155,65.8064516129032,6913,1325,0.320121510198177,0.343526039178213,78.4875
"J Winker","LF",553,1779,267,482,94,3,80,248,270,357,3,3,0.271,0.374,0.462,0.8290656323119,822,0.191,0.756302521008403,6,50,2049,515,0.367008296730112,0.462057335581788,22.2375
"C Reynolds","RF",1222,4495,672,1357,247,107,80,699,260,308,112,40,0.302,0.346,0.458,0.797905138201226,2058,0.156,0.844155844155844,152,73.6842105263158,4755,1371,0.34006309148265,0.457842046718576,56.1875
"G Beckham","2B",1069,3403,420,807,187,7,80,351,266,670,35,20,0.237,0.3,0.367,0.659185492543534,1248,0.13,0.397014925373134,55,63.6363636363636,3669,771,0.292450258926138,0.366735233617396,42.5375
"D Green","2B",1288,4007,427,960,145,23,80,422,345,785,26,20,0.24,0.303,0.347,0.647004632976849,1391,0.107,0.439490445859873,46,56.5217391304348,4352,849,0.299862132352941,0.347142500623908,50.0875
"T Moore","CF",1298,4700,719,1318,263,28,80,513,406,368,82,0,0.28,0.34,0.399,0.737003691943563,1877,0.119,1.10326086956522,82,100,5106,1232,0.337641989815903,0.39936170212766,58.75
"S Mack","LF",923,2857,436,853,155,28,80,398,256,509,90,43,0.299,0.364,0.456,0.812670813431452,1304,0.157,0.502946954813359,133,67.6691729323308,3113,834,0.356247992290395,0.456422821141057,35.7125
"A Kennedy","2B",1691,5473,682,1488,288,42,80,571,401,839,179,62,0.272,0.327,0.384,0.705288461927283,2100,0.112,0.477949940405244,241,74.2738589211618,5874,1253,0.321586653047327,0.383701808879956,68.4125
"B Campaneris","SS",2328,8684,1181,2249,313,86,79,646,618,1142,649,199,0.259,0.311,0.342,0.65033673288192,2971,0.083,0.541155866900175,848,76.5330188679245,9302,1827,0.308213287465061,0.342123445416859,109.924050632911
"E Fletcher","1B",1415,4879,723,1323,228,58,79,616,851,495,32,0,0.271,0.384,0.39,0.769650534201677,1904,0.119,1.71919191919192,32,100,5730,1339,0.379406631762653,0.390243902439024,61.7594936708861
"W Merrifield","2B",909,3633,523,1036,220,26,79,405,246,624,175,43,0.285,0.331,0.425,0.755765924160436,1545,0.14,0.394230769230769,218,80.2752293577982,3879,928,0.330497550915184,0.425268373245252,45.9873417721519
"B Young","1B",728,2403,320,656,121,17,79,415,274,161,9,0,0.273,0.352,0.436,0.783525325008538,1048,0.163,1.70186335403727,9,100,2677,735,0.347403810235338,0.4361215147732,30.4177215189873
"D Rice","C",1309,3826,342,908,177,20,79,441,382,522,2,3,0.237,0.312,0.356,0.662544298664928,1362,0.119,0.731800766283525,5,40,4208,783,0.306558935361217,0.355985363303711,48.4303797468354
"J Beniquez","CF",1500,4651,610,1274,190,30,79,476,349,551,104,76,0.274,0.327,0.379,0.70322825198882,1761,0.105,0.633393829401089,180,57.7777777777778,5000,1086,0.3246,0.37862825198882,58.873417721519
"E Young Sr.","2B",1730,6119,996,1731,327,46,79,543,660,462,465,168,0.283,0.359,0.39,0.742803309905491,2387,0.107,1.42857142857143,633,73.4597156398104,6779,1539,0.35270688892167,0.390096420983821,77.4556962025316
"E Perez","1B",754,1800,238,445,88,3,79,294,194,393,19,13,0.247,0.326,0.431,0.751572495263569,776,0.184,0.493638676844784,32,59.375,1994,532,0.320461384152457,0.431111111111111,22.7848101265823
"B Tillman","C",775,2329,189,540,68,10,79,282,228,510,1,0,0.232,0.3,0.371,0.67175601103765,865,0.139,0.447058823529412,1,100,2557,471,0.300351974970669,0.371404036066982,29.4810126582278
"C Grimm","1B",2166,7917,908,2299,394,108,79,1077,578,410,57,44,0.29,0.341,0.397,0.736042547968427,3146,0.107,1.40975609756098,101,56.4356435643564,8495,1985,0.338669805768099,0.397372742200328,100.215189873418
"R Tellez","1B",432,1394,182,328,70,2,79,216,130,349,3,3,0.235,0.306,0.458,0.7589180477261,639,0.223,0.372492836676218,6,50,1524,398,0.300524934383202,0.458393113342898,17.6455696202532
"D Bartell","SS",2016,7629,1131,2165,442,71,79,710,748,627,109,3,0.284,0.355,0.391,0.739139085787407,2986,0.107,1.19298245614035,112,97.3214285714286,8377,1841,0.34773785364689,0.391401232140516,96.5696202531646
"W McGee","CF",2201,7649,1010,2254,350,94,79,856,448,1238,352,121,0.295,0.333,0.396,0.729703317984563,3029,0.101,0.361873990306947,473,74.4186046511628,8097,1866,0.333703840928739,0.395999477055824,96.8227848101266
"L Gomez","3B",611,1916,241,466,92,2,79,259,255,399,4,10,0.243,0.336,0.417,0.749119634506481,799,0.174,0.639097744360902,14,28.5714285714286,2171,500,0.332105020727775,0.417014613778706,24.253164556962
"J Moore","LF",1335,5427,809,1615,258,53,79,513,348,247,46,0,0.298,0.344,0.408,0.748242146650107,2216,0.11,1.40890688259109,46,100,5775,1322,0.33991341991342,0.408328726736687,68.6962025316456
"B Drury","2B",647,2113,248,531,133,6,79,277,136,503,4,6,0.251,0.301,0.432,0.728663336094898,913,0.181,0.27037773359841,10,40,2249,525,0.296576256113828,0.43208707998107,26.746835443038
"J Profar","LF",837,2727,379,648,139,15,78,313,305,502,46,14,0.238,0.322,0.385,0.699719191356251,1051,0.147,0.607569721115538,60,76.6666666666667,3032,692,0.314313984168865,0.385405207187385,34.9615384615385
"J McCann","C",783,2621,265,637,105,10,78,316,172,734,11,9,0.243,0.296,0.38,0.669660333861853,996,0.137,0.23433242506812,20,55,2793,581,0.289652703186538,0.380007630675315,33.6025641025641
"B Werber","3B",1296,5024,875,1363,271,50,78,539,701,363,215,68,0.271,0.364,0.392,0.752243762690179,1968,0.121,1.93112947658402,283,75.9717314487633,5725,1414,0.360524017467249,0.39171974522293,64.4102564102564
"J Javier","2B",1622,5722,722,1469,216,55,78,506,314,812,135,63,0.257,0.296,0.355,0.649990595863245,2029,0.098,0.386699507389163,198,68.1818181818182,6036,1228,0.295394300861498,0.354596295001748,73.3589743589744
"O Velez","OF",637,1802,244,452,87,11,78,271,336,413,6,10,0.251,0.369,0.441,0.809745226434821,795,0.19,0.813559322033898,16,37.5,2138,515,0.368568755846586,0.441176470588235,23.1025641025641
"G Kell","3B",1795,6702,881,2054,385,50,78,870,621,287,51,36,0.306,0.367,0.414,0.779044537935016,2773,0.108,2.16376306620209,87,58.6206896551724,7323,1751,0.36528745049843,0.413757087436586,85.9230769230769
"O Herrera","CF",817,2915,376,791,158,19,78,305,211,663,68,25,0.271,0.326,0.419,0.739405352551335,1221,0.148,0.318250377073906,93,73.1182795698925,3126,681,0.320537428023033,0.418867924528302,37.3717948717949
"P Bradley","LF",1022,3695,565,1058,179,43,78,376,432,718,155,62,0.286,0.369,0.421,0.78241731650673,1557,0.135,0.601671309192201,217,71.4285714285714,4127,941,0.361037072934335,0.421380243572395,47.3717948717949
"A Johnson","LF",1322,4623,550,1331,180,33,78,525,244,626,113,63,0.288,0.326,0.392,0.715344939393935,1811,0.104,0.389776357827476,176,64.2045454545455,4867,1075,0.323607972056708,0.391736967337227,59.2692307692308
"E Anthony","RF",682,1999,249,462,81,8,78,269,217,491,24,14,0.231,0.305,0.397,0.703106291412855,793,0.166,0.441955193482688,38,63.1578947368421,2216,518,0.306407942238267,0.396698349174587,25.6282051282051
"M Blowers","3B",761,2300,290,591,116,8,78,365,248,610,7,8,0.257,0.329,0.416,0.74536482151389,957,0.159,0.40655737704918,15,46.6666666666667,2548,655,0.329277864992151,0.416086956521739,29.4871794871795
"L Roberts","RF",901,2737,342,731,126,28,78,328,256,428,26,25,0.267,0.332,0.419,0.748841438694916,1147,0.152,0.598130841121495,51,50.9803921568627,2993,670,0.329769462078182,0.419071976616734,35.0897435897436
"G Geiger","CF",954,2569,388,633,91,29,77,283,341,466,62,29,0.246,0.337,0.394,0.729024758587387,1013,0.148,0.731759656652361,91,68.1318681318681,2910,671,0.334707903780069,0.394316854807318,33.3636363636364
"M May","C",1192,3693,313,971,147,11,77,443,305,361,4,13,0.263,0.318,0.371,0.690402471747653,1371,0.108,0.844875346260388,17,23.5294117647059,3998,756,0.319159579789895,0.371242891957758,47.961038961039
"M West","LF",824,2676,338,681,136,20,77,380,353,340,19,0,0.254,0.344,0.407,0.747943768286731,1088,0.153,1.03823529411765,19,100,3029,718,0.341366787718719,0.406576980568012,34.7532467532468
"M Scutaro","SS",1391,4887,683,1355,269,21,77,509,474,570,55,22,0.277,0.341,0.388,0.729340395684495,1897,0.111,0.831578947368421,77,71.4285714285714,5361,1192,0.341167692594665,0.38817270308983,63.4675324675325
"L Stanton","OF",829,2575,294,628,114,13,77,358,236,636,36,27,0.244,0.311,0.388,0.695325092476505,999,0.144,0.371069182389937,63,57.1428571428571,2811,652,0.307363927427962,0.387961165048544,33.4415584415584
"R Rollins","3B",1002,3303,419,887,125,20,77,399,266,410,17,10,0.269,0.328,0.388,0.711494436864964,1283,0.119,0.648780487804878,27,62.962962962963,3569,818,0.323059680582796,0.388434756282168,42.8961038961039
"D Slaught","C",1327,4063,415,1151,235,28,77,476,311,559,18,15,0.283,0.338,0.412,0.746012533957342,1673,0.129,0.556350626118068,33,54.5454545454545,4374,891,0.334247828074989,0.411764705882353,52.7662337662338
"D Santana","RF",516,1680,233,428,87,2,77,244,209,612,30,12,0.255,0.341,0.446,0.783644029342812,750,0.191,0.341503267973856,42,71.4285714285714,1889,477,0.33721545791424,0.446428571428571,21.8181818181818
"J Dwyer","RF",1328,2761,409,719,115,17,77,349,402,402,26,15,0.26,0.353,0.398,0.7524545567908,1099,0.138,1,41,63.4146341463415,3163,758,0.354410369901992,0.398044186888808,35.8571428571429
"V Davis","C",1458,4255,388,1312,244,22,77,647,386,326,6,0,0.308,0.369,0.43,0.796186698488489,1831,0.122,1.1840490797546,6,100,4641,1035,0.365869424692954,0.430317273795535,55.2597402597403
"J Davenport","3B",1502,4427,552,1142,177,37,77,456,382,673,16,25,0.258,0.318,0.367,0.683745648019067,1624,0.109,0.567607726597325,41,39.0243902439024,4809,1008,0.316905801621959,0.366839846397109,57.4935064935065
"D Navarro","C",1009,3207,322,802,142,6,77,367,265,518,14,12,0.25,0.309,0.37,0.677443513541087,1187,0.12,0.511583011583012,26,53.8461538461538,3472,689,0.307315668202765,0.370127845338322,41.6493506493507
"D Valle","C",970,2775,314,658,121,12,77,350,258,413,5,7,0.237,0.314,0.373,0.674623822635692,1034,0.136,0.624697336561743,12,41.6666666666667,3033,664,0.302011210023079,0.372612612612613,36.038961038961
"C Snyder","C",715,2087,227,467,98,1,77,298,309,560,0,3,0.224,0.328,0.382,0.706240155889908,798,0.158,0.551785714285714,3,0,2396,525,0.323873121869783,0.382367034020125,27.1038961038961
"D Wert","3B",1110,3840,417,929,129,15,77,366,389,529,22,24,0.242,0.314,0.343,0.655147185603373,1319,0.101,0.735349716446125,46,47.8260869565217,4229,783,0.31165760227004,0.343489583333333,49.8701298701299
"J Clements","C",1157,4283,619,1226,226,60,77,687,339,299,55,0,0.286,0.347,0.421,0.759564621707407,1803,0.135,1.13377926421405,55,100,4622,1306,0.338598009519688,0.420966612187719,55.6233766233766
"J Stone","OF",1200,4494,739,1391,268,105,77,707,463,352,45,40,0.31,0.376,0.467,0.841306261889634,2100,0.157,1.31534090909091,85,52.9411764705882,4957,1446,0.374016542263466,0.467289719626168,58.3636363636364
"T Laudner","C",734,2038,221,458,97,5,77,263,190,553,3,3,0.225,0.292,0.391,0.681422805122775,796,0.166,0.343580470162749,6,50,2228,484,0.290843806104129,0.390578999018646,26.4675324675325
"G Mitterwald","C",887,2645,251,623,93,7,76,301,222,607,14,17,0.236,0.296,0.362,0.656925987196723,958,0.126,0.365733113673806,31,45.1612903225806,2867,552,0.294733170561563,0.362192816635161,34.8026315789474
"R Ankiel","CF",653,1921,260,462,101,10,76,251,162,555,21,12,0.24,0.302,0.422,0.721743880894967,811,0.182,0.291891891891892,33,63.6363636363636,2083,511,0.299567930868939,0.422175950026028,25.2763157894737
"S Bilko","1B",600,1738,220,432,85,13,76,276,234,395,2,4,0.249,0.336,0.444,0.781341543402806,771,0.195,0.592405063291139,6,33.3333333333333,1972,496,0.337728194726166,0.44361334867664,22.8684210526316
"M Loretta","2B",1726,5812,768,1713,309,22,76,629,555,605,47,35,0.295,0.36,0.395,0.75091233607217,2294,0.1,0.917355371900826,82,57.3170731707317,6367,1397,0.356211716664049,0.394700619408121,76.4736842105263
"M Giles","2B",792,2934,468,813,187,16,76,333,318,523,70,25,0.277,0.353,0.429,0.777233830620515,1260,0.152,0.608030592734226,95,73.6842105263158,3252,801,0.347785977859779,0.429447852760736,38.6052631578947
"P Kelly","RF",1385,4338,620,1147,189,35,76,418,588,768,250,118,0.264,0.354,0.377,0.728884025766686,1634,0.113,0.765625,368,67.9347826086957,4926,1038,0.352212748680471,0.376671277086215,57.0789473684211
"T Horton","1B",636,2228,251,597,102,15,76,297,140,319,12,8,0.268,0.313,0.43,0.740766321752632,957,0.162,0.438871473354232,20,60,2368,548,0.311233108108108,0.429533213644524,29.3157894736842
"H Morris","1B",1246,3998,535,1216,246,21,76,513,356,548,45,24,0.304,0.361,0.433,0.794263921119954,1732,0.129,0.64963503649635,69,65.2173913043478,4354,1048,0.361047312815802,0.433216608304152,52.6052631578947
"R Garr","LF",1317,5108,717,1562,212,64,75,408,246,445,172,83,0.306,0.339,0.416,0.754097083862679,2127,0.11,0.552808988764045,255,67.4509803921569,5354,1125,0.337691445648114,0.416405638214565,68.1066666666667
"S West","OF",1753,6148,934,1838,347,101,75,838,696,540,53,56,0.299,0.371,0.425,0.79510492595084,2612,0.126,1.28888888888889,109,48.6238532110092,6844,1772,0.370251315020456,0.424853610930384,81.9733333333333
"T Bernazard","2B",1071,3700,523,970,177,30,75,391,428,606,113,55,0.262,0.339,0.387,0.725689817724701,1432,0.125,0.706270627062706,168,67.2619047619048,4128,914,0.338662790697674,0.387027027027027,49.3333333333333
"J Burkett","LF",707,8421,1720,2850,320,182,75,952,1029,230,389,0,0.338,0.415,0.446,0.85686023037644,3759,0.108,4.47391304347826,389,100,9450,2672,0.41047619047619,0.446384039900249,112.28
"T Taylor","2B",2195,7680,1005,2007,298,86,75,598,613,1083,234,111,0.261,0.321,0.352,0.667752013495317,2702,0.091,0.566020313942752,345,67.8260869565217,8293,1603,0.315929096828651,0.351822916666667,102.4
"J Kendall","C",2085,7627,1030,2195,394,35,75,744,721,686,189,89,0.288,0.366,0.378,0.727435549279603,2884,0.09,1.05102040816327,278,67.9856115107914,8348,1774,0.349305222807858,0.378130326471745,101.693333333333
"Y Solarte","3B",670,2407,282,620,124,6,75,307,189,326,6,5,0.258,0.315,0.408,0.719194561573428,981,0.15,0.579754601226994,11,54.5454545454545,2596,589,0.311633281972265,0.407561279601163,32.0933333333333
"W Helms","1B",1212,2711,280,694,151,14,75,374,220,687,3,12,0.256,0.318,0.405,0.716855561852271,1098,0.149,0.320232896652111,15,20,2931,654,0.311838962811327,0.405016599040944,36.1466666666667
"H Davis","1B",1417,6653,1001,1841,361,145,75,951,525,45,285,2,0.277,0.335,0.408,0.738005471819068,2717,0.131,11.6666666666667,287,99.3031358885017,7178,1952,0.329618278071886,0.408387193747182,88.7066666666667
"W Betemit","3B",805,2093,264,558,126,8,75,283,211,612,9,8,0.267,0.332,0.442,0.775716716103944,925,0.175,0.344771241830065,17,52.9411764705882,2304,547,0.333767361111111,0.441949354992833,27.9066666666667
"H Hooper","RF",2311,8785,1429,2466,389,160,75,817,1136,412,375,121,0.281,0.368,0.387,0.750091574319308,3400,0.106,2.75728155339806,496,75.6048387096774,9921,2246,0.363068239088802,0.387023335230507,117.133333333333
"D Coles","3B",957,2891,333,709,142,14,75,368,237,445,20,23,0.245,0.307,0.382,0.684304451331011,1104,0.137,0.532584269662921,43,46.5116279069767,3128,701,0.302429667519182,0.38187478381183,38.5466666666667
"T McCraw","1B",1469,3956,484,972,150,42,75,404,332,544,143,68,0.246,0.309,0.362,0.665833496823265,1431,0.116,0.610294117647059,211,67.7725118483412,4288,888,0.30410447761194,0.361729019211325,52.7466666666667
"B Reynolds","LF",496,1789,275,503,97,18,75,241,199,440,16,8,0.281,0.361,0.481,0.834393167276437,861,0.2,0.452272727272727,24,66.6666666666667,1988,516,0.353118712273642,0.481274455002795,23.8533333333333
"D Gladden","LF",1197,4501,663,1215,203,40,74,446,337,625,222,93,0.27,0.324,0.382,0.702931019233336,1720,0.112,0.5392,315,70.4761904761905,4838,1109,0.32079371641174,0.382137302821595,60.8243243243243
"E Konetchy","1B",1933,7649,972,2150,344,182,74,992,689,545,255,5,0.281,0.346,0.403,0.74315634127357,3080,0.122,1.26422018348624,260,98.0769230769231,8338,1964,0.340489325977453,0.402667015296117,103.364864864865
"M Taylor","CF",843,2571,311,620,114,12,74,281,191,823,95,30,0.241,0.296,0.381,0.67480244615554,980,0.14,0.232077764277035,125,76,2762,592,0.293627805937726,0.381174640217814,34.7432432432432
"L Doyle","2B",1767,6509,960,1887,299,123,74,793,625,274,298,27,0.29,0.357,0.408,0.759859749518501,2654,0.118,2.28102189781022,325,91.6923076923077,7134,1753,0.352116624614522,0.407743124903979,87.9594594594595
"J Denny","3B",1237,4946,714,1286,238,76,74,667,173,602,130,0,0.26,0.287,0.384,0.668761044757102,1898,0.124,0.287375415282392,130,100,5119,1381,0.285016604805626,0.383744439951476,66.8378378378378
"J Lefebvre","2B",922,3014,313,756,126,18,74,404,322,447,8,15,0.251,0.323,0.378,0.701376390592901,1140,0.127,0.720357941834452,23,34.7826086956522,3336,717,0.323141486810552,0.378234903782349,40.7297297297297
"A D?az","SS",585,1990,264,530,120,4,74,270,139,322,14,11,0.266,0.32,0.442,0.756443089095076,880,0.176,0.43167701863354,25,56,2129,534,0.314232033818694,0.442211055276382,26.8918918918919
"O McDowell","CF",829,2829,458,715,125,28,74,266,294,550,169,53,0.253,0.323,0.395,0.718279423114993,1118,0.142,0.534545454545455,222,76.1261261261261,3123,724,0.323086775536343,0.39519264757865,38.2297297297297
"K Seitzer","3B",1439,5278,739,1557,285,35,74,613,669,617,80,49,0.295,0.375,0.404,0.778626191074078,2134,0.109,1.08427876823339,129,62.015503875969,5947,1352,0.374306372961157,0.404319818112922,71.3243243243243
"M Yastrzemski","CF",452,1530,255,372,98,12,74,221,175,439,13,6,0.243,0.327,0.468,0.788794970578652,716,0.225,0.398633257403189,19,68.4210526315789,1705,476,0.320821114369501,0.46797385620915,20.6756756756757
"K Tucker","RF",402,1404,214,376,85,11,74,260,144,266,54,8,0.268,0.336,0.502,0.838054064798251,705,0.234,0.541353383458647,62,87.0967741935484,1548,474,0.335917312661499,0.502136752136752,18.972972972973
"A Kosco","RF",658,1963,204,464,75,8,73,267,99,350,5,8,0.236,0.273,0.394,0.667330334762456,774,0.158,0.282857142857143,13,38.4615384615385,2062,471,0.273035887487876,0.39429444727458,26.8904109589041
"G Watkins","OF",894,3207,490,925,192,42,73,420,246,382,61,0,0.288,0.347,0.443,0.781906813857718,1420,0.155,0.643979057591623,61,100,3453,910,0.33912539820446,0.442781415653259,43.9315068493151
"R Mulliniks","3B",1325,3569,445,972,226,17,73,435,460,555,15,12,0.272,0.354,0.407,0.761979640322707,1451,0.135,0.828828828828829,27,55.5555555555556,4029,880,0.355423181931,0.406556458391706,48.8904109589041
"O Saenz","1B",733,1663,226,438,106,5,73,275,148,355,3,4,0.263,0.34,0.465,0.788400743369261,773,0.202,0.416901408450704,7,42.8571428571429,1811,501,0.32357813362783,0.464822609741431,22.7808219178082
"O Hale","2B",1062,3701,551,1071,240,51,73,573,353,315,57,45,0.289,0.352,0.441,0.792219918962155,1632,0.152,1.12063492063492,102,55.8823529411765,4054,1124,0.351258016773557,0.440961902188598,50.6986301369863
"H Simpson","OF",888,2829,343,752,101,41,73,381,271,429,17,18,0.266,0.331,0.408,0.7379179922234,1154,0.142,0.631701631701632,35,48.5714285714286,3100,724,0.33,0.4079179922234,38.7534246575342
"R Swoboda","RF",928,2581,285,624,87,24,73,344,299,647,20,14,0.242,0.324,0.379,0.699409009212622,978,0.137,0.462132921174652,34,58.8235294117647,2880,629,0.320486111111111,0.378922898101511,35.3561643835616
"A Benintendi","LF",750,2812,399,783,170,18,73,384,311,578,70,25,0.278,0.351,0.43,0.779891676903659,1208,0.152,0.538062283737024,95,73.6842105263158,3123,783,0.350304194684598,0.429587482219061,38.5205479452055
"J Moore","RF",846,3013,439,926,155,26,73,452,195,176,23,0,0.307,0.352,0.449,0.798161106526747,1352,0.142,1.10795454545455,23,100,3208,891,0.349438902743142,0.448722203783604,41.2739726027397
"B Allen","2B",1141,3404,357,815,140,21,73,351,370,424,13,16,0.239,0.314,0.357,0.671217253058685,1216,0.118,0.872641509433962,29,44.8275862068966,3774,708,0.313990461049285,0.357226792009401,46.6301369863014
"W Smith","C",361,1217,194,320,64,5,73,235,154,273,6,0,0.263,0.357,0.504,0.8494306586667,613,0.241,0.564102564102564,6,100,1371,429,0.345733041575492,0.503697617091208,16.6712328767123
"H Blanco","C",971,2761,274,615,145,11,72,298,254,546,6,11,0.223,0.288,0.361,0.64968877692907,998,0.138,0.465201465201465,17,35.2941176470588,3015,572,0.288225538971808,0.361463237957262,38.3472222222222
"C Maybin","CF",1162,3824,556,973,173,34,72,354,368,921,187,55,0.254,0.323,0.374,0.693849013063336,1430,0.12,0.39956568946797,242,77.2727272727273,4192,910,0.319895038167939,0.373953974895398,53.1111111111111
"R Jefferson","DH",680,2123,285,637,131,11,72,300,146,451,2,5,0.3,0.349,0.474,0.818943689412294,1006,0.174,0.323725055432373,7,28.5714285714286,2269,585,0.345085940943147,0.473857748469147,29.4861111111111
"G Burns","1B",1869,6573,901,2018,444,72,72,951,363,433,154,63,0.307,0.354,0.429,0.772613546452221,2822,0.122,0.838337182448037,217,70.9677419354839,6936,1852,0.343281430219146,0.429332116233075,91.2916666666667
"J Lindell","CF",854,2795,401,762,124,48,72,404,289,366,17,13,0.273,0.344,0.429,0.769413720535791,1198,0.156,0.789617486338798,30,56.6666666666667,3084,805,0.340791180285344,0.428622540250447,38.8194444444444
"M Young","LF",635,1840,244,454,80,6,72,235,237,465,22,17,0.247,0.338,0.414,0.746821816583283,762,0.167,0.509677419354839,39,56.4102564102564,2077,479,0.332691381800674,0.414130434782609,25.5555555555556
"F Demaree","RF",1155,4144,578,1241,190,36,72,591,359,269,33,0,0.299,0.357,0.415,0.770135278754533,1719,0.116,1.33457249070632,33,100,4503,1169,0.35531867643793,0.414816602316602,57.5555555555556
"G Davis","SS",991,9031,1539,2660,451,163,72,1437,870,180,616,0,0.295,0.361,0.404,0.76102526964686,3653,0.109,4.83333333333333,616,100,9901,2976,0.356529643470357,0.404495626176503,125.430555555556
"F Leach","LF",991,3733,543,1147,196,53,72,509,163,189,32,4,0.307,0.341,0.446,0.782264266041647,1665,0.139,0.862433862433862,36,88.8888888888889,3896,1052,0.336242299794661,0.446021966246986,51.8472222222222
"M Page","DH",673,2104,297,560,84,21,72,259,245,449,104,55,0.266,0.346,0.429,0.771406245194541,902,0.163,0.5456570155902,159,65.4088050314465,2349,556,0.34269902085994,0.428707224334601,29.2222222222222
"S Souza Jr.","RF",505,1669,223,383,71,8,72,207,198,601,42,17,0.229,0.318,0.411,0.722218995174297,686,0.182,0.329450915141431,59,71.1864406779661,1867,430,0.311194429566149,0.411024565608149,23.1805555555556
"B Lawrie","3B",588,2217,266,578,112,13,71,253,153,487,41,19,0.261,0.315,0.419,0.727473550184706,929,0.158,0.314168377823409,60,68.3333333333333,2370,519,0.308438818565401,0.419034731619305,31.2253521126761
"B Lowe","2B",540,7065,1131,1929,230,85,71,984,473,215,302,0,0.273,0.325,0.36,0.678454002433906,2542,0.087,2.2,302,100,7538,2115,0.318652162377288,0.359801840056617,99.5070422535211
"R Hassey","C",1192,3440,348,914,172,7,71,438,385,378,14,10,0.266,0.34,0.382,0.721293889648883,1313,0.116,1.01851851851852,24,58.3333333333333,3825,786,0.339607843137255,0.381686046511628,48.4507042253521
"B Ewing","C",1315,5363,1129,1625,250,178,71,883,392,294,354,0,0.303,0.351,0.456,0.806192930192442,2444,0.153,1.33333333333333,354,100,5755,2012,0.350477845351868,0.455715084840574,75.5352112676056
"C Hern?ndez","2B",1186,4278,590,1144,182,33,71,369,453,926,91,40,0.267,0.341,0.375,0.712736084961385,1605,0.108,0.489200863930886,131,69.4656488549618,4731,959,0.337560769393363,0.375175315568022,60.2535211267606
"H Dozier","3B",568,2018,250,483,106,26,71,226,185,594,17,12,0.239,0.306,0.423,0.726414156387339,854,0.184,0.311447811447811,29,58.6206896551724,2203,476,0.303222877893781,0.423191278493558,28.4225352112676
"J Harrison","2B",1170,3899,492,1060,215,32,71,378,184,642,91,37,0.272,0.317,0.398,0.70272871514434,1552,0.126,0.286604361370716,128,71.09375,4083,870,0.304677932892481,0.398050782251859,54.9154929577465
"W Rosario","1B",447,1512,204,413,83,3,71,241,73,354,11,7,0.273,0.306,0.473,0.779508203561831,715,0.2,0.206214689265537,18,61.1111111111111,1585,445,0.306624605678233,0.472883597883598,21.2957746478873
"B Lewis","3B",1348,5261,830,1563,249,93,71,607,573,303,83,59,0.297,0.368,0.42,0.786391892736358,2211,0.123,1.89108910891089,142,58.4507042253521,5834,1437,0.366129585190264,0.420262307546094,74.0985915492958
"C Ruiz","C",1137,3539,405,935,223,7,71,415,403,499,25,10,0.264,0.35,0.391,0.730775103080568,1385,0.127,0.807615230460922,35,71.4285714285714,3942,820,0.339421613394216,0.391353489686352,49.8450704225352
"T Brookens","3B",1336,3865,477,950,175,40,71,431,281,605,86,60,0.246,0.296,0.367,0.663794963770626,1418,0.121,0.464462809917355,146,58.9041095890411,4146,908,0.296912686927159,0.366882276843467,54.4366197183099
"E Jim?nez","RF",321,1205,160,331,56,2,71,214,89,325,0,0,0.275,0.327,0.501,0.825819774638132,604,0.226,0.273846153846154,0,0,1294,374,0.324574961360124,0.501244813278008,16.9718309859155
"L Forsythe","2B",971,3120,389,762,150,13,71,307,343,757,42,16,0.244,0.326,0.369,0.687997752800669,1151,0.125,0.453104359313078,58,72.4137931034483,3463,696,0.319087496390413,0.368910256410256,43.943661971831
"V Law","3B",1212,3802,453,972,193,26,71,442,408,602,34,26,0.256,0.326,0.376,0.703908806591355,1430,0.12,0.677740863787375,60,56.6666666666667,4210,895,0.327790973871734,0.376117832719621,53.5492957746479
"T Greene","C",536,1573,181,397,82,3,71,217,67,332,5,4,0.252,0.286,0.444,0.726664909370009,698,0.192,0.201807228915663,9,55.5555555555556,1640,398,0.282926829268293,0.443738080101716,22.1549295774648
"D Thon","SS",1387,4449,496,1176,193,42,71,435,348,658,167,63,0.264,0.317,0.374,0.692164733774523,1666,0.11,0.52887537993921,230,72.6086956521739,4797,931,0.317698561601001,0.374466172173522,62.6619718309859
"J Judge","1B",2173,7898,1185,2352,433,159,71,1034,965,478,213,92,0.298,0.378,0.42,0.794105637810665,3316,0.122,2.01882845188284,305,69.8360655737705,8863,2219,0.374252510436647,0.419853127374019,111.239436619718
"C Kotchman","1B",939,3071,322,799,157,7,71,388,267,339,14,9,0.26,0.326,0.385,0.704569447774744,1183,0.125,0.787610619469027,23,60.8695652173913,3338,710,0.319352905931696,0.385216541843048,43.2535211267606
"D Span","CF",1359,5326,773,1498,265,72,71,490,515,716,185,59,0.281,0.347,0.398,0.742680083419787,2120,0.117,0.71927374301676,244,75.8196721311475,5841,1263,0.344632768361582,0.398047315058205,75.0140845070423
"E Smith","OF",1014,3195,468,881,181,62,70,541,319,359,54,27,0.276,0.344,0.437,0.778423885499807,1396,0.161,0.88857938718663,81,66.6666666666667,3514,1009,0.341491178144565,0.436932707355243,45.6428571428571
"M Carey","CF",2466,9363,1545,2665,419,159,70,800,1040,695,738,92,0.285,0.361,0.386,0.741921055663736,3612,0.101,1.49640287769784,830,88.9156626506024,10403,2345,0.356147265211958,0.385773790451778,133.757142857143
"R Milligan","1B",703,2118,305,553,106,10,70,284,447,431,16,18,0.261,0.391,0.42,0.80959914738057,889,0.159,1.03712296983759,34,47.0588235294118,2565,589,0.389863547758285,0.419735599622285,30.2571428571429
"A Meadows","RF",414,1496,209,389,82,15,70,237,156,362,23,13,0.26,0.335,0.475,0.805170527378902,711,0.215,0.430939226519337,36,63.8888888888889,1652,446,0.329903147699758,0.475267379679144,21.3714285714286
"M Webster","CF",1265,3419,504,900,150,55,70,342,325,578,160,73,0.263,0.33,0.401,0.727892130577492,1370,0.138,0.562283737024221,233,68.6695278969957,3744,846,0.327190170940171,0.400701959637321,48.8428571428571
"H Richardson","2B",1331,5642,1120,1688,303,126,70,822,377,445,205,0,0.299,0.344,0.435,0.777855148404859,2453,0.136,0.847191011235955,205,100,6019,1942,0.343080245888021,0.434774902516838,80.6
"J Hairston","2B",1442,4387,580,1126,233,22,70,420,373,572,147,68,0.257,0.324,0.368,0.682593194560706,1613,0.111,0.652097902097902,215,68.3720930232558,4760,1000,0.314915966386555,0.367677228174151,62.6714285714286
"A Simmons","SS",1226,4441,501,1169,201,23,70,444,304,461,72,24,0.263,0.312,0.366,0.676565787378791,1626,0.103,0.65943600867679,96,75,4745,945,0.310432033719705,0.366133753659086,63.4428571428571
"J Mumphrey","CF",1585,4993,660,1442,217,55,70,575,478,688,174,80,0.289,0.349,0.396,0.747296223852491,1979,0.107,0.694767441860465,254,68.503937007874,5471,1235,0.350941326996893,0.396354896855598,71.3285714285714
"G Templeton","SS",2079,7721,893,2096,329,106,70,728,375,1092,242,129,0.271,0.304,0.369,0.673947070460778,2847,0.098,0.343406593406593,371,65.2291105121294,8096,1621,0.305212450592885,0.368734619867893,110.3
"D Williams","LF",1023,2959,358,768,157,12,70,331,227,392,12,21,0.26,0.312,0.392,0.703990209786946,1159,0.132,0.579081632653061,33,36.3636363636364,3186,689,0.312303829252982,0.391686380533964,42.2714285714286
"G Hubbard","2B",1354,4441,545,1084,214,22,70,448,539,640,35,35,0.244,0.328,0.349,0.675374454358755,1552,0.105,0.8421875,70,50,4980,993,0.325903614457831,0.349470839900923,63.4428571428571
"D Cruz","SS",1234,4124,442,1109,250,16,70,464,132,429,16,28,0.269,0.293,0.388,0.679803670791917,1601,0.119,0.307692307692308,44,36.3636363636364,4256,906,0.291588345864662,0.388215324927255,58.9142857142857
"G Braggs","LF",692,2336,308,601,102,16,70,321,211,472,58,26,0.257,0.322,0.405,0.723344110180658,945,0.148,0.447033898305085,84,69.0476190476191,2547,629,0.318806438947782,0.404537671232877,33.3714285714286
"K Shoppach","C",572,1616,208,361,92,2,70,216,155,624,1,0,0.223,0.312,0.413,0.704108337852419,667,0.19,0.248397435897436,1,100,1771,424,0.291360813099944,0.412747524752475,23.0857142857143
"J Shelby","CF",1036,3090,389,739,128,24,70,313,182,671,98,40,0.239,0.281,0.364,0.645556887506825,1125,0.125,0.27123695976155,138,71.0144927536232,3272,702,0.281479217603912,0.364077669902913,44.1428571428571
"B Joyce","3B",904,3304,820,970,152,106,70,607,718,280,264,0,0.294,0.435,0.467,0.887004044342075,1544,0.173,2.56428571428571,264,100,4022,1427,0.419691695673794,0.467312348668281,47.2
"T O'Neill","CF",408,1235,213,310,53,3,70,198,109,427,35,9,0.251,0.32,0.469,0.780581863312126,579,0.218,0.255269320843091,44,79.5454545454545,1344,411,0.311755952380952,0.468825910931174,17.6428571428571
"L Nix","CF",758,1915,235,460,110,11,69,249,122,534,9,5,0.24,0.286,0.417,0.702946661693398,799,0.177,0.228464419475655,14,64.2857142857143,2037,484,0.285714285714286,0.417232375979112,27.7536231884058
"M Carreon","1B",738,2012,246,557,108,5,69,289,140,246,12,11,0.277,0.327,0.438,0.76225453967644,882,0.161,0.569105691056911,23,52.1739130434783,2152,535,0.323884758364312,0.438369781312127,29.1594202898551
"D Fondy","1B",967,3502,437,1000,144,47,69,373,203,526,84,53,0.286,0.324,0.413,0.737317715498605,1445,0.127,0.385931558935361,137,61.3138686131387,3705,810,0.324696356275304,0.412621359223301,50.7536231884058
"C Vollmer","LF",685,2021,283,508,77,10,69,339,243,328,7,6,0.251,0.335,0.402,0.733495077306655,812,0.151,0.740853658536585,13,53.8461538461538,2264,622,0.331713780918728,0.401781296387927,29.2898550724638
"C Smith","3B",771,2484,228,594,83,18,69,281,130,565,7,12,0.239,0.279,0.37,0.647340531043668,920,0.131,0.230088495575221,19,36.8421052631579,2614,509,0.276970160673298,0.37037037037037,36
"R Fick","1B",846,2373,287,613,116,12,69,324,235,386,6,9,0.258,0.328,0.405,0.729704575244507,960,0.147,0.60880829015544,15,40,2608,611,0.325153374233129,0.404551201011378,34.3913043478261
"B Falk","LF",1354,4652,657,1463,300,59,69,784,412,279,47,49,0.314,0.372,0.449,0.819099872449499,2088,0.135,1.47670250896057,96,48.9583333333333,5064,1441,0.370260663507109,0.44883920894239,67.4202898550725
"J Ellis","1B",883,2672,259,699,116,13,69,391,190,403,6,10,0.262,0.312,0.392,0.70283751155969,1048,0.13,0.471464019851117,16,37.5,2862,650,0.310621942697414,0.392215568862275,38.7246376811594
"R Rolfe","3B",1175,4827,942,1394,257,67,69,497,526,335,44,20,0.289,0.36,0.413,0.771356059583115,1992,0.124,1.57014925373134,64,68.75,5353,1439,0.358677377171679,0.412678682411436,69.9565217391304
"M Bellhorn","2B",731,2107,324,484,113,13,69,246,346,723,30,13,0.23,0.341,0.394,0.732286202244339,830,0.164,0.478561549100968,43,69.7674418604651,2453,570,0.338361190379128,0.393925011865211,30.536231884058
"R Healy","1B",405,1514,177,395,80,0,69,214,75,357,0,1,0.261,0.298,0.45,0.746245863029597,682,0.189,0.210084033613445,1,0,1589,391,0.295783511642542,0.450462351387054,21.9420289855072
"T Lepcio","2B",729,2092,233,512,91,11,69,251,209,471,11,15,0.245,0.318,0.398,0.71104757013951,832,0.153,0.443736730360934,26,42.3076923076923,2301,484,0.313342025206432,0.397705544933078,30.3188405797101
"D Sveum","SS",862,2526,305,597,125,13,69,340,227,656,10,18,0.236,0.298,0.378,0.67737793565157,955,0.142,0.346036585365854,28,35.7142857142857,2753,645,0.299309843806756,0.378068091844814,36.6086956521739
"M Lamb","3B",975,2706,382,746,132,19,69,349,226,409,7,10,0.276,0.332,0.415,0.746518020184543,1123,0.139,0.552567237163814,17,41.1764705882353,2932,731,0.331514324693042,0.4150036954915,39.2173913043478
"J Reilly","1B",1142,4684,898,1352,215,139,69,740,157,156,245,0,0.289,0.325,0.438,0.749799561142539,2052,0.149,1.00641025641026,245,100,4841,1638,0.311712456104111,0.438087105038429,67.8840579710145
"B Bichette","SS",396,1625,264,484,101,3,69,240,101,370,46,14,0.298,0.341,0.491,0.830010874409484,798,0.193,0.272972972972973,60,76.6666666666667,1726,504,0.338933951332561,0.491076923076923,23.5507246376812
"G Van Haltren","CF",245,8021,1639,2539,285,161,69,1014,868,305,583,0,0.317,0.386,0.417,0.801310386313102,3353,0.1,2.84590163934426,583,100,8889,2653,0.383282708966138,0.418027677346964,116.246376811594
"K Kelly","RF",1455,5894,1357,1813,359,102,69,950,549,418,368,0,0.308,0.368,0.438,0.80484169049767,2583,0.13,1.3133971291866,368,100,6443,2307,0.366599410212634,0.438242280285036,85.4202898550725
"T Long","CF",890,3068,428,824,166,21,69,376,227,460,27,15,0.269,0.318,0.404,0.722814287381814,1239,0.135,0.493478260869565,42,64.2857142857143,3295,804,0.31896813353566,0.403846153846154,44.463768115942
"J Greengrass","LF",504,1793,243,482,82,16,69,282,165,271,6,9,0.269,0.33,0.448,0.778291984433847,803,0.179,0.608856088560886,15,40,1958,525,0.330439223697651,0.447852760736196,25.9855072463768
"P Borders","C",1099,3282,289,831,168,12,69,346,155,557,9,14,0.253,0.288,0.375,0.661649572163131,1230,0.122,0.278276481149013,23,39.1304347826087,3437,635,0.286878091358743,0.374771480804388,47.5652173913044
"S Henderson","LF",1085,3484,459,976,162,49,68,428,386,677,79,58,0.28,0.352,0.413,0.765256009754448,1440,0.133,0.570162481536189,137,57.6642335766423,3870,887,0.351937984496124,0.413318025258324,51.2352941176471
"M Scioscia","C",1441,4373,398,1131,198,12,68,446,567,307,29,24,0.259,0.344,0.356,0.6997731756611,1557,0.097,1.84690553745928,53,54.7169811320755,4940,844,0.343724696356275,0.356048479304825,64.3088235294118
"E Roush","CF",1748,7363,1099,2376,339,182,68,981,484,260,268,92,0.323,0.369,0.446,0.81034853712246,3283,0.123,1.86153846153846,360,74.4444444444444,7847,2080,0.364470498279597,0.445878038842863,108.279411764706
"N Ahmed","SS",819,2707,331,638,145,23,68,305,203,578,36,21,0.236,0.29,0.382,0.670606687257295,1033,0.146,0.35121107266436,57,63.1578947368421,2910,636,0.289003436426117,0.381603250831178,39.8088235294118
"G Wood","LF",1280,5371,965,1467,228,132,68,601,418,547,113,0,0.273,0.329,0.403,0.728335852519042,2163,0.13,0.764168190127971,113,100,5789,1566,0.325617550526861,0.40271830199218,78.9852941176471
"A Shamsky","RF",665,1686,194,426,60,15,68,233,188,254,5,7,0.253,0.33,0.427,0.75468767209653,720,0.174,0.740157480314961,12,41.6666666666667,1874,427,0.327641408751334,0.427046263345196,24.7941176470588
"L Gurriel Jr.","LF",472,1740,225,495,101,5,68,254,106,382,14,14,0.284,0.328,0.466,0.791086038779094,810,0.182,0.277486910994764,28,50,1846,479,0.325568797399783,0.46551724137931,25.5882352941176
"K Reitz","3B",1344,4777,366,1243,243,12,68,548,184,518,10,14,0.26,0.29,0.359,0.64644621600926,1714,0.099,0.355212355212355,24,41.6666666666667,4961,914,0.287643620237855,0.358802595771405,70.25
"R McMillan","SS",2093,6752,739,1639,253,35,68,594,665,711,41,36,0.243,0.314,0.321,0.631431563009789,2166,0.078,0.935302390998594,77,53.2467532467532,7417,1333,0.310637724147229,0.320793838862559,99.2941176470588
"L Boudreau","SS",1646,6029,861,1779,385,66,68,789,796,309,51,50,0.295,0.38,0.415,0.791951842043068,2500,0.12,2.57605177993528,101,50.4950495049505,6825,1650,0.377289377289377,0.414662464753691,88.6617647058823
"M Shannon","3B",882,2780,313,710,116,23,68,367,224,525,19,17,0.255,0.311,0.387,0.697969134678941,1076,0.132,0.426666666666667,36,52.7777777777778,3004,680,0.310918774966711,0.38705035971223,40.8823529411765
"J Blanchard","C",516,1193,137,285,36,2,67,200,136,163,2,0,0.239,0.317,0.441,0.757684814288516,526,0.202,0.834355828220859,2,100,1329,337,0.316779533483822,0.440905280804694,17.8059701492537
"D Ruf","1B",562,1420,195,340,66,3,67,202,172,444,6,1,0.239,0.329,0.432,0.753298181046075,613,0.193,0.387387387387387,7,85.7142857142857,1592,397,0.321608040201005,0.43169014084507,21.1940298507463
"M Wilson","OF",1403,5094,731,1397,227,71,67,438,282,866,327,98,0.274,0.314,0.386,0.698454545613888,1967,0.112,0.325635103926097,425,76.9411764705882,5376,1169,0.312313988095238,0.386140557518649,76.0298507462687
"B Tuttle","OF",1270,4268,578,1105,149,47,67,443,480,416,38,44,0.259,0.334,0.363,0.696758226617788,1549,0.104,1.15384615384615,82,46.3414634146341,4748,1021,0.333824768323505,0.362933458294283,63.7014925373134
"J Russell","LF",1035,3595,556,959,175,51,67,428,503,427,59,0,0.267,0.36,0.4,0.756481230709916,1437,0.133,1.17798594847775,59,100,4098,984,0.356759394826745,0.399721835883171,53.6567164179104
"M Matheny","C",1305,3877,353,925,190,9,67,443,266,795,8,14,0.239,0.293,0.344,0.631553320357697,1334,0.105,0.334591194968553,22,36.3636363636364,4143,796,0.287472845763939,0.344080474593758,57.865671641791
"P Munoz","RF",517,1708,203,467,75,8,67,252,100,418,11,10,0.273,0.315,0.444,0.757985585790968,759,0.171,0.239234449760766,21,52.3809523809524,1808,455,0.313606194690265,0.444379391100703,25.4925373134328
"B Schneider","C",1048,3165,284,781,167,9,67,387,331,526,4,8,0.247,0.32,0.369,0.686798182350581,1167,0.122,0.629277566539924,12,33.3333333333333,3496,671,0.318077803203661,0.368720379146919,47.2388059701493
"B Hamelin","DH",497,1272,179,313,70,3,67,209,206,293,11,8,0.246,0.352,0.464,0.814986680964417,590,0.218,0.703071672354949,19,57.8947368421053,1478,388,0.351150202976996,0.463836477987421,18.9850746268657
"B Hunter","1B",699,1555,187,364,90,7,67,259,141,335,4,9,0.234,0.298,0.43,0.727984514348116,669,0.196,0.42089552238806,13,30.7692307692308,1696,446,0.297759433962264,0.430225080385852,23.2089552238806
"R Castro","C",567,1426,155,338,66,0,67,217,151,375,2,0,0.237,0.31,0.424,0.734346109617476,605,0.187,0.402666666666667,2,100,1577,372,0.310082435003171,0.424263674614306,21.2835820895522
"M Teahen","3B",831,2873,388,759,163,26,67,332,259,679,45,17,0.264,0.327,0.409,0.734012088591586,1175,0.145,0.381443298969072,62,72.5806451612903,3132,720,0.325031928480204,0.408980160111382,42.8805970149254
"F Robinson","RF",1011,3284,458,929,140,36,67,426,408,282,42,21,0.283,0.365,0.409,0.770782334784496,1342,0.126,1.4468085106383,63,66.6666666666667,3692,884,0.362134344528711,0.408647990255786,49.0149253731343
"C McGehee","3B",850,2798,285,721,141,6,67,380,249,517,7,10,0.258,0.317,0.384,0.702548916158173,1075,0.126,0.481624758220503,17,41.1764705882353,3047,665,0.318345914013784,0.384203002144389,41.7611940298507
"E McKean","SS",1654,6890,1227,2083,272,158,67,1124,635,158,323,0,0.302,0.364,0.417,0.778032007483521,2872,0.115,4.01898734177215,323,100,7525,2351,0.361196013289037,0.416835994194485,102.835820895522
"D Vogelbach","DH",471,1314,176,286,51,1,67,190,246,396,0,0,0.218,0.343,0.411,0.75198454513523,540,0.193,0.621212121212121,0,0,1560,366,0.341025641025641,0.410958904109589,19.6119402985075
"F Clarke","LF",1373,8568,1619,2672,361,220,67,1015,874,135,506,0,0.312,0.386,0.429,0.804360881541065,3674,0.117,6.47407407407407,506,100,9442,2634,0.375556026265622,0.428804855275443,127.880597014925
"K Garcia","RF",488,1463,180,352,44,13,66,212,81,330,10,13,0.241,0.279,0.424,0.704227154083985,620,0.183,0.245454545454545,23,43.4782608695652,1544,392,0.280440414507772,0.423786739576213,22.1666666666667
"D Bissonette","1B",604,2291,359,699,117,50,66,391,233,269,17,0,0.305,0.371,0.486,0.855505696167944,1114,0.181,0.866171003717472,17,100,2524,750,0.369255150554675,0.486250545613269,34.7121212121212
"A Eaton","CF",915,3439,566,950,167,46,66,319,346,679,87,32,0.276,0.354,0.409,0.751534788422336,1407,0.133,0.509572901325479,119,73.109243697479,3785,885,0.342404227212682,0.409130561209654,52.1060606060606
"D Mientkiewicz","1B",1087,3312,422,899,221,11,66,405,438,472,14,15,0.271,0.36,0.405,0.76112270531401,1340,0.134,0.927966101694915,29,48.2758620689655,3750,827,0.356533333333333,0.404589371980676,50.1818181818182
"J Candelario","3B",609,2193,284,526,127,13,66,248,239,590,7,5,0.24,0.322,0.4,0.714464721782226,877,0.16,0.405084745762712,12,58.3333333333333,2432,532,0.314555921052632,0.399908800729594,33.2272727272727
"T Benzinger","1B",924,2856,316,733,135,18,66,376,181,552,21,29,0.257,0.301,0.386,0.686809231430471,1102,0.129,0.327898550724638,50,42,3037,692,0.300954889693777,0.385854341736695,43.2727272727273
"J Mercer","2B",950,3104,330,796,173,15,66,308,246,589,13,11,0.256,0.315,0.386,0.696676219418372,1197,0.13,0.417657045840407,24,54.1666666666667,3350,638,0.311044776119403,0.385631443298969,47.030303030303
"L Bell","3B",896,3239,404,938,184,49,66,509,276,322,25,5,0.29,0.346,0.438,0.783166397088823,1418,0.148,0.857142857142857,30,83.3333333333333,3515,913,0.345376955903272,0.437789441185551,49.0757575757576
"E Marrero","C",724,1906,262,463,99,12,66,261,168,372,56,11,0.243,0.303,0.411,0.715575642466919,784,0.168,0.451612903225806,67,83.5820895522388,2074,523,0.304243008678881,0.411332633788038,28.8787878787879
"D Dietz","C",646,1829,226,478,89,6,66,301,381,402,4,6,0.261,0.39,0.425,0.813510090077163,777,0.164,0.947761194029851,10,40,2210,527,0.38868778280543,0.424822307271733,27.7121212121212
"M Rettenmund","RF",1023,2555,393,693,114,16,66,329,445,382,68,28,0.271,0.381,0.406,0.785204174820613,1037,0.135,1.16492146596859,96,70.8333333333333,3000,722,0.379333333333333,0.40587084148728,38.7121212121212
"D Viciedo","LF",483,1675,200,425,73,7,66,211,95,388,2,3,0.254,0.298,0.424,0.717665907749389,710,0.17,0.244845360824742,5,40,1770,411,0.293785310734463,0.423880597014925,25.3787878787879
"B Cox","3B",1058,3712,470,974,174,32,66,351,298,218,42,21,0.262,0.318,0.38,0.697056120474675,1410,0.118,1.36697247706422,63,66.6666666666667,4010,821,0.317206982543641,0.379849137931034,56.2424242424242
"A Hedges","C",608,1819,174,343,55,2,66,207,126,556,12,3,0.189,0.247,0.33,0.5709826721934,600,0.141,0.226618705035971,15,80,1945,381,0.241131105398458,0.329851566794942,27.5606060606061
"L Walls","RF",902,2558,331,670,88,31,66,284,245,470,21,18,0.262,0.329,0.398,0.724403123315045,1018,0.136,0.521276595744681,39,53.8461538461538,2803,615,0.326435961469854,0.397967161845192,38.7575757575758
"S White","C",1043,3502,324,916,167,20,66,421,218,381,14,15,0.262,0.305,0.377,0.682051730808202,1321,0.115,0.572178477690289,29,48.2758620689655,3720,745,0.304838709677419,0.377213021130782,53.0606060606061
"D Cater","1B",1289,4451,491,1229,191,29,66,519,254,406,26,30,0.276,0.316,0.377,0.691741196082219,1676,0.101,0.625615763546798,56,46.4285714285714,4705,1010,0.31519659936238,0.376544596719838,67.4393939393939
"M Andrews","2B",893,3116,441,803,140,4,66,316,458,390,18,25,0.258,0.353,0.369,0.721567942198434,1149,0.111,1.17435897435897,43,41.8604651162791,3574,757,0.35282596530498,0.368741976893453,47.2121212121212
"K Stinnett","C",734,2033,228,476,91,4,65,230,196,567,10,5,0.234,0.313,0.379,0.680231099377101,770,0.145,0.345679012345679,15,66.6666666666667,2229,458,0.301480484522207,0.378750614854894,31.2769230769231
"J Gilliam","2B",1956,7119,1163,1889,304,71,65,558,1036,416,203,111,0.265,0.36,0.355,0.714062651659978,2530,0.09,2.49038461538462,314,64.6496815286624,8155,1721,0.358675659104844,0.355386992555134,109.523076923077
"R Johnson","LF",1320,3630,518,1014,215,23,65,408,181,728,41,29,0.279,0.335,0.405,0.718524670863594,1470,0.126,0.248626373626374,70,58.5714285714286,3811,926,0.313565993177644,0.40495867768595,55.8461538461538
"A Jackson","CF",1115,4200,621,1145,218,53,65,381,374,1120,114,45,0.273,0.333,0.396,0.72828492306411,1664,0.123,0.333928571428571,159,71.6981132075472,4574,1002,0.332094446873634,0.396190476190476,64.6153846153846
"J Vosmik","OF",1413,5472,818,1682,335,92,65,874,514,272,23,24,0.307,0.369,0.438,0.80472149440312,2396,0.131,1.88970588235294,47,48.936170212766,5986,1692,0.366855997327097,0.437865497076023,84.1846153846154
"P Fox","RF",1461,5636,895,1678,314,75,65,694,392,471,158,81,0.298,0.347,0.415,0.75805326267812,2337,0.117,0.832271762208068,239,66.1087866108787,6028,1589,0.343397478433975,0.414655784244145,86.7076923076923
"J Hermida","RF",632,2012,248,517,104,9,65,250,216,517,22,8,0.257,0.334,0.415,0.743507536468799,834,0.158,0.41779497098646,30,73.3333333333333,2228,498,0.328994614003591,0.414512922465209,30.9538461538462
"O Burns","RF",1187,4637,869,1389,224,129,65,832,464,182,263,0,0.3,0.368,0.446,0.808808795139561,2066,0.146,2.54945054945055,263,100,5101,1701,0.363262105469516,0.445546689670045,71.3384615384615
"D Mueller","RF",1245,4364,499,1292,139,37,65,520,167,146,11,8,0.296,0.322,0.39,0.711554843393743,1700,0.094,1.14383561643836,19,57.8947368421053,4531,1019,0.322003972632973,0.38955087076077,67.1384615384615
"C Spikes","OF",670,2039,240,502,72,12,65,256,154,388,27,25,0.246,0.304,0.389,0.688049742291615,793,0.143,0.396907216494845,52,51.9230769230769,2193,496,0.299133606931145,0.388916135360471,31.3692307692308
"J Kelley","LF",739,7006,1421,2220,358,194,65,1194,911,163,443,0,0.317,0.402,0.451,0.846662783962832,3161,0.134,5.58895705521472,443,100,7917,2615,0.395478085133258,0.451184698829575,107.784615384615
"I Noren","CF",1093,3119,443,857,157,35,65,453,335,350,34,24,0.275,0.348,0.41,0.755174451449389,1279,0.135,0.957142857142857,58,58.6206896551724,3454,896,0.345107122177186,0.410067329272203,47.9846153846154
"T Grieve","LF",671,1907,209,474,76,10,65,254,135,424,7,7,0.249,0.301,0.401,0.699390666994685,765,0.152,0.318396226415094,14,50,2042,463,0.298237022526934,0.40115364446775,29.3384615384615
"B Wynegar","C",1301,4330,498,1102,176,15,65,506,626,428,10,13,0.255,0.348,0.347,0.695781444843957,1503,0.092,1.46261682242991,23,43.4782608695652,4956,1004,0.348668280871671,0.347113163972286,66.6153846153846
"M Sanguillen","C",1448,5062,566,1500,205,57,65,585,223,331,36,38,0.296,0.326,0.398,0.723883485274554,2014,0.102,0.673716012084592,74,48.6486486486487,5285,1151,0.326017029328288,0.397866455946266,77.8769230769231
"B Holliday","CF",928,3648,728,1135,162,71,65,617,359,211,248,0,0.311,0.376,0.448,0.820764183512187,1634,0.137,1.70142180094787,248,100,4007,1345,0.37284751684552,0.447916666666667,56.1230769230769
"J Collins","3B",956,6795,1055,1999,352,116,65,983,426,32,194,0,0.294,0.343,0.409,0.744656084947234,2778,0.115,13.3125,194,100,7221,2038,0.335826062872178,0.408830022075055,104.538461538462
"J Lahoud","RF",791,1925,239,429,68,12,65,218,309,340,20,20,0.223,0.334,0.372,0.702297201455662,716,0.149,0.908823529411765,40,50,2234,457,0.33034914950761,0.371948051948052,29.6153846153846
"L Clinton","RF",691,2153,270,532,112,31,65,269,188,418,12,7,0.247,0.308,0.418,0.726046705142859,901,0.171,0.449760765550239,19,63.1578947368421,2341,539,0.307560871422469,0.41848583372039,33.1230769230769
"M Anderson","2B",1151,3204,392,849,174,20,63,371,227,471,71,24,0.265,0.314,0.391,0.704372740137201,1252,0.126,0.481953290870488,95,74.7368421052632,3431,763,0.313611192072282,0.390761548064919,50.8571428571429
"D Norris","C",610,1967,242,453,98,4,63,247,195,541,26,6,0.23,0.304,0.38,0.679997008926661,748,0.15,0.360443622920518,32,81.25,2162,489,0.299722479185939,0.380274529740722,31.2222222222222
"B Kennedy","RF",1485,4624,514,1176,196,41,63,514,364,443,45,50,0.254,0.309,0.355,0.664061047552188,1643,0.101,0.821670428893905,95,47.3684210526316,4988,1028,0.308740978348035,0.355320069204152,73.3968253968254
"C Johnson","3B",839,2811,256,773,154,10,63,339,144,753,18,4,0.275,0.313,0.404,0.714448134323642,1136,0.129,0.191235059760956,22,81.8181818181818,2955,595,0.310321489001692,0.404126645321949,44.6190476190476
"R Ledee","LF",855,2030,290,494,120,17,63,318,244,495,29,15,0.243,0.325,0.412,0.736853529511158,837,0.169,0.492929292929293,44,65.9090909090909,2274,608,0.324538258575198,0.412315270935961,32.2222222222222
"T Houston","3B",700,1805,197,479,84,6,63,253,119,408,10,6,0.265,0.312,0.423,0.734079508871753,764,0.158,0.291666666666667,16,62.5,1924,450,0.310810810810811,0.423268698060942,28.6507936507937
"T Leach","CF",1996,7959,1355,2143,266,172,63,810,820,278,361,14,0.269,0.34,0.37,0.707154394658546,2942,0.101,2.94964028776978,375,96.2666666666667,8779,2165,0.337509966966625,0.369644427691921,126.333333333333
"L Moss","C",824,2234,210,552,75,4,63,276,282,316,1,5,0.247,0.333,0.369,0.700323658220335,824,0.122,0.892405063291139,6,16.6666666666667,2516,486,0.33147853736089,0.368845120859445,35.4603174603175
"J Marisnick","CF",831,1977,277,451,93,13,63,213,116,650,79,29,0.228,0.281,0.384,0.654818032795205,759,0.156,0.178461538461538,108,73.1481481481482,2093,490,0.270903010033445,0.38391502276176,31.3809523809524
"M Nieves","RF",458,1228,163,284,53,6,63,187,136,483,4,12,0.231,0.314,0.438,0.746028637748718,538,0.207,0.281573498964803,16,25,1364,350,0.30791788856305,0.438110749185668,19.4920634920635
"J Newman","C",735,2123,189,475,85,4,63,233,116,369,7,12,0.224,0.264,0.357,0.620528013965591,757,0.133,0.314363143631436,19,36.8421052631579,2239,422,0.263957123715945,0.356570890249647,33.6984126984127
"R Laureano","RF",410,1469,226,368,89,4,63,185,121,438,45,15,0.251,0.324,0.445,0.752747986693554,654,0.194,0.276255707762557,60,75,1590,411,0.307547169811321,0.445200816882233,23.3174603174603
"C Pinder","LF",553,1603,204,388,89,3,62,197,103,475,5,4,0.242,0.294,0.417,0.705150220242087,669,0.175,0.216842105263158,9,55.5555555555556,1706,401,0.287807737397421,0.417342482844666,25.8548387096774
"E Hendricks","C",711,1888,205,415,66,7,62,230,229,319,1,5,0.22,0.306,0.361,0.664903214894758,681,0.141,0.717868338557994,6,16.6666666666667,2117,435,0.304204062352385,0.360699152542373,30.4516129032258
"G Urshela","SS",605,1992,249,549,106,6,62,258,133,410,4,2,0.276,0.322,0.428,0.749154027876211,853,0.152,0.324390243902439,6,66.6666666666667,2125,507,0.320941176470588,0.428212851405622,32.1290322580645
"T Puhl","RF",1530,4855,676,1361,226,56,62,435,505,507,217,99,0.28,0.349,0.388,0.736393854619795,1885,0.108,0.996055226824458,316,68.6708860759494,5360,1111,0.348134328358209,0.388259526261586,78.3064516129032
"C Heisey","LF",697,1594,218,380,69,12,62,178,110,414,25,10,0.238,0.296,0.413,0.700984030489924,659,0.175,0.265700483091787,35,71.4285714285714,1704,396,0.287558685446009,0.413425345043915,25.7096774193548
"D Brown","C",636,1866,175,455,62,3,62,223,119,356,7,6,0.244,0.291,0.38,0.669125893288625,709,0.136,0.334269662921348,13,53.8461538461538,1985,398,0.289168765743073,0.379957127545552,30.0967741935484
"D Revering","1B",557,1832,205,486,83,16,62,234,148,240,2,10,0.265,0.318,0.43,0.749787173040448,787,0.165,0.616666666666667,12,16.6666666666667,1980,439,0.32020202020202,0.429585152838428,29.5483870967742
"D Bautista","RF",895,2517,317,685,121,19,62,319,149,409,37,16,0.272,0.315,0.409,0.722045529260742,1030,0.137,0.364303178484108,53,69.811320754717,2666,636,0.312828207051763,0.409217322208979,40.5967741935484
"R Davis","CF",1448,4244,637,1111,226,43,62,387,267,844,415,108,0.262,0.311,0.379,0.68459897274878,1609,0.117,0.316350710900474,523,79.3499043977055,4511,1024,0.305475504322767,0.379123468426013,68.4516129032258
"S Horn","DH",389,1040,132,250,49,1,62,179,132,323,0,1,0.24,0.328,0.468,0.794207797322132,487,0.228,0.408668730650155,1,0,1172,311,0.325938566552901,0.468269230769231,16.7741935483871
"K Abbott","SS",702,2044,273,523,109,23,62,242,133,571,22,11,0.256,0.305,0.423,0.724032695490212,864,0.167,0.23292469352014,33,66.6666666666667,2177,515,0.301332108406063,0.422700587084149,32.9677419354839
"B Crosby","SS",747,2559,329,605,146,8,62,276,241,516,34,13,0.236,0.304,0.372,0.674553955228047,953,0.136,0.467054263565891,47,72.3404255319149,2800,605,0.302142857142857,0.37241109808519,41.2741935483871
"B Phillips","3B",1062,3278,348,835,135,8,62,356,182,314,25,11,0.255,0.297,0.358,0.651465718205447,1172,0.103,0.579617834394904,36,69.4444444444444,3460,704,0.29393063583815,0.357535082367297,52.8709677419355
"C Guzman","SS",1406,5382,727,1459,238,89,62,467,265,783,125,68,0.271,0.307,0.383,0.68823799063403,2061,0.112,0.338441890166028,193,64.7668393782383,5647,1194,0.305294846821321,0.382943143812709,86.8064516129032
"D Clark","RF",905,1964,248,518,81,8,62,284,222,451,19,12,0.264,0.338,0.408,0.746358981334655,801,0.144,0.492239467849224,31,61.2903225806452,2186,532,0.338517840805124,0.407841140529532,31.6774193548387
"D Lyons","3B",1121,4294,932,1333,244,69,62,755,621,213,224,0,0.31,0.407,0.443,0.840269253603765,1901,0.133,2.91549295774648,224,100,4915,1687,0.397558494404883,0.442710759198882,69.258064516129
"J Bloodworth","2B",1002,3519,347,874,160,20,62,451,202,407,19,22,0.248,0.292,0.358,0.647225844055066,1260,0.11,0.496314496314496,41,46.3414634146341,3721,798,0.289169578070411,0.358056265984655,56.758064516129
"S Schebler","OF",394,1262,174,299,61,4,61,167,114,340,13,11,0.237,0.314,0.437,0.7367539066819,551,0.2,0.335294117647059,24,54.1666666666667,1376,341,0.300145348837209,0.436608557844691,20.6885245901639
"B Johnson","3B",964,3253,419,882,141,33,61,487,347,290,13,11,0.271,0.346,0.391,0.732412559346928,1272,0.12,1.19655172413793,24,54.1666666666667,3600,906,0.341388888888889,0.391023670458039,53.327868852459
"W Garrett","3B",1092,3285,438,786,107,22,61,340,561,529,38,30,0.239,0.35,0.341,0.691177692769811,1120,0.102,1.06049149338374,68,55.8823529411765,3846,778,0.350234009360374,0.340943683409437,53.8524590163934
"G Thomasson","CF",900,2373,315,591,103,25,61,294,291,463,50,16,0.249,0.33,0.391,0.721725834557693,927,0.142,0.628509719222462,66,75.7575757575758,2664,609,0.331081081081081,0.390644753476612,38.9016393442623
"J Wilson","SS",1370,4890,565,1294,243,34,61,426,270,619,43,32,0.265,0.306,0.366,0.66874494697294,1788,0.101,0.436187399030695,75,57.3333333333333,5160,991,0.303100775193798,0.365644171779141,80.1639344262295
"D Alexander","1B",662,2450,369,811,164,30,61,459,248,197,20,28,0.331,0.394,0.497,0.889655829715133,1218,0.166,1.25888324873096,48,41.6666666666667,2698,828,0.392512972572276,0.497142857142857,40.1639344262295
"L Frey","2B",1535,5517,848,1482,263,69,61,549,752,525,105,0,0.269,0.359,0.374,0.730835559157005,2066,0.105,1.43238095238095,105,100,6269,1397,0.356356675705854,0.374478883451151,90.4426229508197
"M Trillo","2B",1780,5950,598,1562,239,33,61,571,452,742,56,57,0.263,0.316,0.345,0.659127006003901,2050,0.082,0.609164420485175,113,49.5575221238938,6402,1169,0.314589190877851,0.34453781512605,97.5409836065574
"A Zarilla","OF",1120,3535,507,975,186,43,61,456,415,382,33,33,0.276,0.357,0.405,0.75642490107962,1430,0.129,1.08638743455497,66,50,3950,963,0.351898734177215,0.404526166902405,57.9508196721311
"M Rivers","CF",1468,5629,785,1660,247,71,61,499,265,471,267,90,0.295,0.327,0.397,0.723121357037635,2232,0.102,0.562632696390658,357,74.7899159663866,5894,1284,0.326603325415677,0.396518031621958,92.2786885245902
"R Fosse","C",924,2957,299,758,117,13,61,324,203,363,15,19,0.256,0.306,0.367,0.670701681913332,1084,0.111,0.559228650137741,34,44.1176470588235,3160,623,0.304113924050633,0.366587757862699,48.4754098360656
"J Priddy","2B",1296,4720,612,1252,232,46,61,541,624,639,44,44,0.265,0.353,0.373,0.72371739571704,1759,0.108,0.976525821596244,88,50,5344,1153,0.351047904191617,0.372669491525424,77.3770491803279
"I Stewart","3B",511,1489,202,341,68,13,61,211,170,473,17,12,0.229,0.315,0.415,0.723060531095828,618,0.186,0.359408033826638,29,58.6206896551724,1659,413,0.308016877637131,0.415043653458697,24.4098360655738
"R Smalley","SS",872,2644,277,601,103,33,61,305,257,541,4,0,0.227,0.3,0.36,0.656198811928278,953,0.133,0.475046210720887,4,100,2901,582,0.295760082730093,0.360438729198185,43.344262295082
"B Schroeder","C",376,1262,153,303,49,1,61,152,58,343,6,5,0.24,0.281,0.426,0.69899990395236,537,0.186,0.169096209912536,11,54.5454545454545,1320,305,0.273484848484848,0.425515055467512,20.6885245901639
"J Rizzo","LF",557,1842,268,497,90,16,61,289,200,197,7,0,0.27,0.345,0.435,0.776728335784572,802,0.165,1.01522842639594,7,100,2042,557,0.341332027424094,0.435396308360478,30.1967213114754
"J Lane","P",500,1211,165,292,64,7,61,189,123,258,10,6,0.241,0.314,0.457,0.767741851617544,553,0.216,0.476744186046512,16,62.5,1334,354,0.311094452773613,0.456647398843931,19.8524590163934
"D Lenhardt","LF",481,1481,192,401,64,9,61,239,214,235,6,7,0.271,0.365,0.45,0.812528009656236,666,0.179,0.91063829787234,13,46.1538461538462,1695,431,0.36283185840708,0.449696151249156,24.2786885245902
"J Choi","1B",488,1468,178,350,88,3,61,225,231,444,6,7,0.238,0.344,0.427,0.769077578893178,627,0.189,0.52027027027027,13,46.1538461538462,1699,403,0.341965862271925,0.427111716621253,24.0655737704918
"W Cromartie","LF",1107,3927,459,1104,229,32,61,391,325,403,50,37,0.281,0.336,0.402,0.738419895453264,1580,0.121,0.806451612903226,87,57.4712643678161,4252,850,0.336077140169332,0.402342755283932,64.3770491803279
"J Reed","C",1234,3101,311,774,144,10,61,323,391,566,7,9,0.25,0.334,0.361,0.695115993695268,1121,0.111,0.690812720848057,16,43.75,3492,634,0.333619702176403,0.361496291518865,50.8360655737705
"A Robinson","C",610,1839,208,478,74,11,61,272,337,194,0,6,0.26,0.375,0.412,0.786177200284682,757,0.152,1.73711340206186,6,0,2176,480,0.374540441176471,0.411636759108211,30.1475409836066
"G Sanchez","1B",700,1998,236,508,126,4,61,266,225,368,12,1,0.254,0.332,0.413,0.742647505805401,825,0.159,0.611413043478261,13,92.3076923076923,2223,502,0.329734592892488,0.412912912912913,32.7540983606557
"S Hogan","C",989,3180,288,939,146,12,61,474,220,188,6,2,0.295,0.348,0.406,0.747171661117277,1292,0.111,1.17021276595745,8,75,3400,762,0.340882352941176,0.406289308176101,52.1311475409836
"E Bouchee","1B",670,2199,298,583,114,21,61,290,340,401,5,8,0.265,0.368,0.419,0.782810439991969,922,0.154,0.84788029925187,13,38.4615384615385,2539,588,0.363528948404884,0.419281491587085,36.0491803278689
"D Nicholson","LF",539,1419,184,301,32,12,61,179,219,573,6,10,0.212,0.318,0.381,0.698010000335582,540,0.169,0.382198952879581,16,37.5,1638,363,0.317460317460317,0.380549682875264,23.2622950819672
"T Naquin","LF",557,1660,226,439,97,12,61,237,117,468,20,13,0.264,0.318,0.448,0.760477249459289,743,0.184,0.25,33,60.6060606060606,1777,463,0.312886888013506,0.447590361445783,27.2131147540984
"R Mountcastle","1B",327,1228,153,321,57,2,61,200,97,349,8,5,0.261,0.316,0.46,0.775569417982914,565,0.199,0.277936962750716,13,61.5384615384615,1325,353,0.315471698113208,0.460097719869707,20.1311475409836
"B Nash","3B",1549,5849,1072,1606,266,87,60,977,803,384,265,0,0.275,0.366,0.381,0.742724599350234,2226,0.106,2.09114583333333,265,100,6652,2049,0.362146722790138,0.380577876560096,97.4833333333333
"H Anderson","LF",484,1586,199,419,82,16,60,242,159,291,3,6,0.264,0.334,0.45,0.780790729773773,713,0.186,0.54639175257732,9,33.3333333333333,1745,441,0.331232091690544,0.449558638083228,26.4333333333333
"C Stengel","RF",1277,4288,575,1219,182,89,60,535,437,453,131,43,0.284,0.356,0.41,0.760690742714996,1759,0.126,0.964679911699779,174,75.2873563218391,4725,1110,0.35047619047619,0.410214552238806,71.4666666666667
"E Cabell","3B",1688,5952,753,1647,263,56,60,596,259,691,238,124,0.277,0.308,0.37,0.676834576791437,2202,0.093,0.374819102749638,362,65.7458563535912,6211,1349,0.306874899372082,0.369959677419355,99.2
"E Brinkman","SS",1846,6045,550,1355,201,38,60,461,444,845,30,35,0.224,0.28,0.3,0.576990264494179,1812,0.076,0.525443786982248,65,46.1538461538462,6489,1011,0.277238403451996,0.299751861042184,100.75
"J Groth","CF",1248,3808,480,1064,197,31,60,486,419,329,19,42,0.279,0.352,0.395,0.745535217280667,1503,0.116,1.27355623100304,61,31.1475409836066,4227,966,0.350839839129406,0.39469537815126,63.4666666666667
"R Wrightstone","3B",930,2992,427,889,152,34,60,425,215,152,35,20,0.297,0.349,0.431,0.775062467796881,1289,0.134,1.41447368421053,55,63.6363636363636,3207,852,0.344246959775491,0.43081550802139,49.8666666666667
"A Russell","2B",615,1987,256,480,100,9,60,253,186,532,17,5,0.242,0.312,0.392,0.698033768042668,778,0.15,0.349624060150376,22,77.2727272727273,2173,509,0.306488725264611,0.391545042778057,33.1166666666667
"B Aspromonte","2B",1324,4369,386,1103,135,26,60,457,333,459,19,24,0.252,0.308,0.336,0.641863389436363,1470,0.084,0.725490196078431,43,44.1860465116279,4702,843,0.305401956614207,0.336461432822156,72.8166666666667
"M LeCroy","C",476,1388,146,361,68,1,60,218,123,332,0,4,0.26,0.326,0.44,0.760519399523571,611,0.18,0.370481927710843,4,0,1511,364,0.320317670416942,0.440201729106628,23.1333333333333
"M Aviles","SS",915,3009,380,786,139,13,60,306,141,424,78,31,0.261,0.295,0.376,0.67015809713716,1131,0.115,0.332547169811321,109,71.5596330275229,3150,686,0.294285714285714,0.375872382851446,50.15
"C Gomez","SS",1515,4604,517,1206,234,18,60,486,408,750,35,33,0.262,0.325,0.36,0.681714363373256,1656,0.098,0.544,68,51.4705882352941,5012,1003,0.322027134876297,0.359687228496959,76.7333333333333
"R Baldelli","CF",519,1910,281,531,99,18,60,262,102,388,60,16,0.278,0.323,0.443,0.757544263216512,846,0.165,0.262886597938144,76,78.9473684210526,2012,543,0.314612326043738,0.442931937172775,31.8333333333333
"F Merkle","1B",1645,5782,720,1580,290,82,60,733,454,583,272,20,0.273,0.331,0.383,0.709083109222424,2214,0.11,0.778730703259005,292,93.1506849315068,6236,1453,0.326170622193714,0.38291248702871,96.3666666666667
"J Michaels","LF",1031,2332,332,613,140,10,59,299,243,496,22,18,0.263,0.335,0.407,0.739802827690719,950,0.144,0.48991935483871,40,55,2575,631,0.332427184466019,0.4073756432247,39.5254237288136
"C Hickman","1B",921,3982,478,1176,217,91,59,614,153,0,72,0,0.295,0.331,0.44,0.761382569810823,1752,0.145,Inf,72,100,4135,1092,0.321402660217654,0.439979909593169,67.4915254237288
"G Perry","1B",1193,3144,383,832,150,11,59,396,328,374,142,75,0.265,0.333,0.376,0.709737514804001,1181,0.111,0.877005347593583,217,65.4377880184332,3472,779,0.334101382488479,0.375636132315522,53.2881355932203
"D Glanville","CF",1115,3964,553,1100,166,32,59,333,208,502,168,36,0.277,0.315,0.38,0.693690239964087,1507,0.103,0.414342629482072,204,82.3529411764706,4172,886,0.313518696069032,0.380171543895055,67.1864406779661
"J Gerut","RF",574,1804,246,472,107,13,59,226,159,261,30,19,0.262,0.325,0.433,0.754927918148723,782,0.171,0.609195402298851,49,61.2244897959184,1963,472,0.321446765155374,0.433481152993348,30.5762711864407
"D Kokos","RF",475,1558,239,410,82,9,59,223,242,252,15,21,0.263,0.365,0.441,0.80317215803737,687,0.178,0.96031746031746,36,41.6666666666667,1800,462,0.362222222222222,0.440949935815148,26.4067796610169
"C Wilson","OF",1280,4624,520,1246,157,114,59,571,241,407,98,15,0.269,0.311,0.391,0.696656080968147,1808,0.122,0.592137592137592,113,86.7256637168142,4865,1091,0.305652620760534,0.391003460207612,78.3728813559322
"A Craig","1B",534,1831,239,506,107,3,59,296,143,394,11,3,0.276,0.333,0.435,0.76350918023879,796,0.159,0.362944162436548,14,78.5714285714286,1974,535,0.328774062816616,0.434735117422174,31.0338983050847
"W Schang","C",1841,5307,768,1506,264,90,59,710,849,573,121,49,0.284,0.393,0.401,0.783345013812718,2127,0.117,1.48167539267016,170,71.1764705882353,6156,1478,0.382553606237817,0.400791407574901,89.9491525423729
"P Martin","3B",1189,4117,756,1227,270,75,59,501,369,438,146,0,0.298,0.358,0.443,0.798814566918092,1824,0.145,0.842465753424658,146,100,4486,1257,0.355773517610343,0.443041049307748,69.7796610169491
"E Brown","LF",739,2249,296,581,112,12,59,326,197,468,52,14,0.258,0.323,0.398,0.715580323334401,894,0.14,0.420940170940171,66,78.7878787878788,2446,622,0.31807031888798,0.397510004446421,38.1186440677966
"R LeFlore","CF",1099,4458,731,1283,172,57,59,353,363,888,455,142,0.288,0.342,0.392,0.733078392173317,1746,0.104,0.408783783783784,597,76.214405360134,4821,1084,0.341422941298486,0.391655450874832,75.5593220338983
"S Spencer","LF",538,1671,208,438,84,8,59,242,152,357,13,11,0.262,0.326,0.428,0.751529840297837,715,0.166,0.425770308123249,24,54.1666666666667,1823,450,0.323642347778387,0.427887492519449,28.3220338983051
"B Sudakis","3B",530,1548,177,362,56,7,59,214,172,313,9,6,0.234,0.311,0.393,0.703875968992248,609,0.159,0.549520766773163,15,60,1720,391,0.31046511627907,0.393410852713178,26.2372881355932
"A Phillips","CF",649,1875,270,463,86,21,59,173,251,485,82,44,0.247,0.343,0.41,0.745441956726246,768,0.163,0.517525773195876,126,65.0793650793651,2126,443,0.335841956726246,0.4096,31.7796610169492
"R Cerone","C",1329,4069,393,998,190,15,59,436,320,450,6,22,0.245,0.301,0.343,0.643132272693396,1395,0.098,0.711111111111111,28,21.4285714285714,4389,829,0.300296195033037,0.342836077660359,68.9661016949153
"P Wisdom","3B",285,892,135,194,43,0,59,140,93,372,14,6,0.217,0.301,0.464,0.755496118913751,414,0.247,0.25,20,70,985,275,0.291370558375635,0.464125560538117,15.1186440677966
"H Zimmerman","3B",1459,5304,695,1566,275,105,58,796,242,404,175,33,0.295,0.331,0.419,0.745495442205843,2225,0.124,0.599009900990099,208,84.1346153846154,5546,1491,0.326000721240534,0.419494720965309,91.448275862069
"D Mesoraco","C",468,1402,152,325,66,2,58,192,138,316,4,7,0.232,0.309,0.406,0.706498138095856,569,0.174,0.436708860759494,11,36.3636363636364,1540,344,0.300649350649351,0.405848787446505,24.1724137931034
"D Mirabelli","C",566,1456,162,337,78,2,58,206,165,415,3,0,0.231,0.317,0.407,0.716965599175655,593,0.176,0.397590361445783,3,100,1621,368,0.309685379395435,0.40728021978022,25.1034482758621
"H Smith","C",879,2682,269,715,148,10,58,323,196,361,7,10,0.267,0.317,0.394,0.710648137351991,1057,0.127,0.542936288088643,17,41.1764705882353,2878,592,0.316539263377345,0.394108873974646,46.2413793103448
"J Foy","3B",716,2484,355,615,102,16,58,291,390,405,99,48,0.248,0.351,0.372,0.721264947438134,923,0.124,0.962962962962963,147,67.3469387755102,2874,646,0.349686847599165,0.371578099838969,42.8275862068966
"E N??ez","SS",858,2813,353,776,148,19,58,309,135,400,142,38,0.276,0.31,0.404,0.712862383940428,1136,0.128,0.3375,180,78.8888888888889,2948,662,0.309023066485753,0.403839317454675,48.5
"K Berry","CF",1384,4136,422,1053,150,23,58,343,298,569,45,46,0.255,0.308,0.344,0.648743248277553,1423,0.089,0.523725834797891,91,49.4505494505495,4434,765,0.30469102390618,0.344052224371373,71.3103448275862
"B Martinez","C",1049,2743,245,618,128,10,58,321,230,419,5,10,0.225,0.284,0.343,0.627924255472665,940,0.118,0.548926014319809,15,33.3333333333333,2973,566,0.285233770602085,0.34269048487058,47.2931034482759
"W Wilmot","OF",960,3981,725,1098,152,92,58,594,349,222,381,0,0.276,0.337,0.404,0.738098751981844,1608,0.128,1.57207207207207,381,100,4330,1319,0.334180138568129,0.403918613413715,68.6379310344828
"G Moore","RF",1042,3543,497,958,179,53,58,436,317,401,31,10,0.27,0.333,0.4,0.730254431492295,1417,0.13,0.790523690773067,41,75.609756097561,3860,933,0.330310880829016,0.39994355066328,61.0862068965517
"J Wyrostek","OF",1221,4240,526,1149,209,45,58,481,482,437,33,13,0.271,0.349,0.383,0.727951659434362,1622,0.112,1.10297482837529,46,71.7391304347826,4722,1007,0.345404489623041,0.382547169811321,73.1034482758621
"A Garc?a","RF",332,1220,171,299,61,7,58,195,74,392,41,11,0.245,0.292,0.449,0.737433805457724,548,0.204,0.188775510204082,52,78.8461538461538,1294,366,0.288253477588872,0.449180327868852,21.0344827586207
"C Jones","LF",881,3687,728,1101,170,98,56,542,237,124,19,0,0.299,0.347,0.443,0.784428552588689,1635,0.144,1.91129032258065,19,100,3924,1270,0.340978593272171,0.443449959316517,65.8392857142857
"D Wakefield","LF",638,2132,334,625,102,29,56,315,360,270,10,17,0.293,0.396,0.447,0.842262971339431,953,0.154,1.33333333333333,27,37.037037037037,2492,649,0.395264847512038,0.446998123827392,38.0714285714286
"E Webb","RF",651,2161,326,661,155,25,56,333,260,202,8,4,0.306,0.381,0.478,0.858903497680809,1034,0.172,1.28712871287129,12,66.6666666666667,2421,659,0.380421313506815,0.478482184173994,38.5892857142857
"B Knoop","2B",1153,3622,337,856,129,29,56,331,305,833,16,17,0.236,0.296,0.334,0.629991196317893,1211,0.098,0.366146458583433,33,48.4848484848485,3927,668,0.295645530939649,0.334345665378244,64.6785714285714
"R Jackson","1B",926,2986,356,774,165,22,56,342,213,329,23,27,0.259,0.314,0.385,0.69399942254225,1151,0.126,0.64741641337386,50,46,3199,698,0.308533916849015,0.385465505693235,53.3214285714286
"R N??ez","3B",307,1055,137,258,51,0,56,154,82,296,1,1,0.245,0.308,0.452,0.751165243198406,477,0.207,0.277027027027027,2,50,1137,291,0.299032541776605,0.452132701421801,18.8392857142857
"M Mieske","RF",663,1547,225,406,78,10,56,226,124,313,7,16,0.262,0.318,0.434,0.751564484376819,672,0.172,0.396166134185303,23,30.4347826086957,1671,451,0.317175344105326,0.434389140271493,27.625
"D Schofield","SS",1368,4299,505,989,137,32,56,353,446,684,120,41,0.23,0.308,0.316,0.618311019471532,1358,0.086,0.652046783625731,161,74.5341614906832,4745,858,0.302423603793467,0.315887415678065,76.7678571428571
"R Church","RF",654,1894,251,500,134,7,56,267,188,459,21,10,0.264,0.336,0.431,0.761285702258104,816,0.167,0.40958605664488,31,67.741935483871,2082,518,0.33045148895293,0.430834213305174,33.8214285714286
"N Lowe","1B",388,1382,186,385,61,6,56,181,151,389,11,2,0.279,0.352,0.453,0.802607941259489,626,0.174,0.388174807197943,13,84.6153846153846,1533,367,0.349641226353555,0.452966714905933,24.6785714285714
"R Mueller","C",986,2911,281,733,123,23,56,373,250,322,14,0,0.252,0.314,0.368,0.678548820100175,1070,0.116,0.77639751552795,14,100,3161,654,0.310977538753559,0.367571281346616,51.9821428571429
"R Hudler","2B",774,1767,261,461,96,10,56,169,77,325,106,43,0.261,0.296,0.422,0.713375612426911,745,0.161,0.236923076923077,149,71.1409395973154,1844,430,0.29175704989154,0.421618562535371,31.5535714285714
"R Manning","CF",1555,5248,664,1349,189,43,56,458,471,616,168,78,0.257,0.317,0.341,0.659700868734514,1792,0.084,0.76461038961039,246,68.2926829268293,5719,1122,0.318237454100367,0.341463414634146,93.7142857142857
"N Reimold","LF",480,1378,179,339,61,7,56,174,150,356,18,7,0.246,0.323,0.422,0.74237741168246,582,0.176,0.421348314606742,25,72,1528,353,0.320026178010471,0.422351233671988,24.6071428571429
"J Daubert","1B",2014,7673,1116,2326,250,165,56,722,623,489,251,78,0.303,0.36,0.401,0.756098087056757,3074,0.098,1.27402862985685,329,76.2917933130699,8296,1838,0.355472516875603,0.400625570181155,137.017857142857
"Y Torrealba","C",907,2875,306,737,162,12,56,339,222,544,19,17,0.256,0.315,0.379,0.689132765228622,1091,0.123,0.408088235294118,36,52.7777777777778,3097,645,0.309654504359057,0.379478260869565,51.3392857142857
"T Lampkin","C",777,1796,224,422,78,8,56,236,193,286,23,17,0.235,0.319,0.381,0.690046928485288,684,0.146,0.674825174825175,40,57.5,1989,460,0.30920060331825,0.380846325167038,32.0714285714286
"J Mayberry","CF",574,1386,172,326,83,3,56,180,119,351,15,7,0.235,0.299,0.421,0.716315983757844,583,0.186,0.339031339031339,22,68.1818181818182,1505,352,0.295681063122924,0.420634920634921,24.75
"B Bonnell","LF",976,3068,363,833,143,24,56,355,229,387,64,39,0.272,0.323,0.389,0.710637737518877,1192,0.117,0.591731266149871,103,62.1359223300971,3297,718,0.322111010009099,0.388526727509778,54.7857142857143
"J Sheckard","OF",1771,7605,1296,2084,354,136,56,813,1135,233,465,0,0.274,0.375,0.378,0.746741876129308,2878,0.104,4.87124463519313,465,100,8740,2109,0.368306636155606,0.378435239973701,135.803571428571
"C O'Brien","C",800,2232,216,493,119,4,56,261,209,354,1,10,0.221,0.303,0.353,0.640633649467945,788,0.132,0.590395480225989,11,9.09090909090909,2441,477,0.287587054485866,0.353046594982079,39.8571428571429
"P Hines","CF",1481,6253,1083,1881,368,84,56,751,366,304,153,0,0.301,0.343,0.413,0.752878829674069,2585,0.112,1.20394736842105,153,100,6619,1834,0.339477262426348,0.413401567247721,111.660714285714
"C Carrasquel","SS",1325,4644,568,1199,172,25,55,474,491,467,31,28,0.258,0.333,0.342,0.670629858589823,1586,0.084,1.05139186295503,59,52.5423728813559,5135,1042,0.329113924050633,0.34151593453919,84.4363636363636
"G Alexander","C",432,1276,169,293,45,11,55,202,154,381,8,12,0.23,0.311,0.411,0.724029418857005,525,0.181,0.404199475065617,20,40,1430,371,0.312587412587413,0.411442006269592,23.2
"H Perry","3B",529,1696,241,461,102,6,55,246,128,291,12,8,0.272,0.335,0.436,0.759237421383648,740,0.164,0.439862542955326,20,60,1824,487,0.322916666666667,0.436320754716981,30.8363636363636
"V Saier","1B",865,2948,455,775,143,61,55,395,378,369,121,26,0.263,0.351,0.409,0.755414353912393,1205,0.146,1.02439024390244,147,82.312925170068,3326,850,0.346662657847264,0.408751696065129,53.6
"D Jennings","CF",567,2076,311,508,99,22,55,191,219,481,95,27,0.245,0.322,0.393,0.709839182943569,816,0.148,0.455301455301455,122,77.8688524590164,2295,502,0.31677559912854,0.393063583815029,37.7454545454545
"R Garko","1B",463,1552,190,427,75,3,55,250,125,272,0,1,0.275,0.347,0.434,0.7627932334987,673,0.159,0.459558823529412,1,0,1677,440,0.329159212880143,0.433634020618557,28.2181818181818
"J Felix","RF",585,2132,309,562,105,24,55,280,158,509,49,40,0.264,0.317,0.413,0.727168454082928,880,0.149,0.31041257367387,89,55.0561797752809,2290,589,0.314410480349345,0.412757973733583,38.7636363636364
"C Bennett","C",1062,3821,549,978,203,67,55,533,478,572,42,0,0.256,0.34,0.387,0.726016573606553,1480,0.131,0.835664335664336,42,100,4299,1082,0.338683414747616,0.387333158858937,69.4727272727273
"R P?rez","C",514,1514,165,314,57,4,55,193,191,525,2,1,0.207,0.298,0.359,0.655500761223691,544,0.152,0.363809523809524,3,66.6666666666667,1705,358,0.296187683284457,0.359313077939234,27.5272727272727
"D Sisler","1B",800,2606,302,720,118,28,55,360,226,253,6,3,0.276,0.336,0.406,0.740409463602031,1059,0.13,0.893280632411067,9,66.6666666666667,2832,662,0.334039548022599,0.406369915579432,47.3818181818182
"C Dalrymple","C",1079,3042,243,710,98,23,55,327,387,403,3,13,0.233,0.322,0.335,0.654895332363533,1019,0.102,0.96029776674938,16,18.75,3429,570,0.319918343540391,0.334976988823143,55.3090909090909
"C Widger","C",613,1826,180,435,104,7,55,222,141,384,10,9,0.238,0.296,0.393,0.686040923874822,718,0.155,0.3671875,19,52.6315789473684,1967,402,0.292831723436706,0.393209200438116,33.2
"G Alley","SS",1195,3927,442,999,140,44,55,342,300,622,63,30,0.254,0.31,0.354,0.661779209393287,1392,0.1,0.482315112540193,93,67.741935483871,4227,784,0.307310149041874,0.354469060351413,71.4
"C Duncan","RF",389,1147,164,295,55,5,55,175,160,316,4,3,0.257,0.348,0.458,0.805841258490764,525,0.201,0.506329113924051,7,57.1428571428571,1307,339,0.348125478194338,0.457715780296425,20.8545454545455
"C V?zquez","C",735,2440,283,640,127,5,55,276,163,475,28,16,0.262,0.31,0.386,0.69455577738171,942,0.124,0.343157894736842,44,63.6363636363636,2603,559,0.308490203611218,0.386065573770492,44.3636363636364
"R Jordan","1B",677,2104,261,592,116,10,55,304,77,303,10,6,0.281,0.308,0.424,0.731169685304993,893,0.143,0.254125412541254,16,62.5,2181,565,0.306740027510316,0.424429657794677,38.2545454545455
"J Jaso","C",808,2224,295,573,143,12,55,281,319,412,16,10,0.258,0.356,0.407,0.757691271284977,905,0.149,0.774271844660194,26,61.5384615384615,2543,576,0.350766810853323,0.406924460431655,40.4363636363636
"C Castillo","RF",631,1519,190,383,71,8,55,197,90,291,15,11,0.252,0.298,0.418,0.712009593829312,635,0.166,0.309278350515464,26,57.6923076923077,1609,387,0.29397141081417,0.418038183015142,27.6181818181818
"C Mullins","CF",433,1597,230,421,82,14,55,157,137,340,77,23,0.264,0.329,0.436,0.757616465128171,696,0.172,0.402941176470588,100,77,1734,387,0.321799307958477,0.435817157169693,29.0363636363636
"J Baker","2B",748,1793,244,474,108,15,54,235,139,472,14,1,0.264,0.318,0.432,0.748966535376245,774,0.168,0.294491525423729,15,93.3333333333333,1932,479,0.317287784679089,0.431678750697156,33.2037037037037
"C Kreuter","C",944,2505,289,593,123,8,54,274,361,593,5,7,0.237,0.335,0.357,0.689754336407436,894,0.12,0.608768971332209,12,41.6666666666667,2866,563,0.332868108862526,0.35688622754491,46.3888888888889
"B Hatcher","LF",1233,4339,586,1146,210,30,54,399,267,476,218,87,0.264,0.312,0.364,0.670452040220893,1578,0.1,0.560924369747899,305,71.4754098360656,4606,985,0.306773773339123,0.36367826688177,80.3518518518518
"D Bergman","1B",1349,2679,312,690,100,16,54,289,380,347,19,14,0.258,0.348,0.367,0.71708874406182,984,0.109,1.09510086455331,33,57.5757575757576,3059,601,0.349787512258908,0.367301231802912,49.6111111111111
"B Butler","CF",2213,8180,1359,2375,277,131,54,578,1129,907,558,257,0.29,0.377,0.376,0.752449045682583,3076,0.086,1.24476295479603,815,68.4662576687117,9309,1937,0.376409925878182,0.376039119804401,151.481481481481
"J Jackson","LF",1332,4981,872,1772,307,168,54,785,519,158,202,61,0.356,0.423,0.517,0.933911445310361,2577,0.161,3.28481012658228,263,76.8060836501901,5500,1657,0.416545454545455,0.517365990764907,92.2407407407407
"D Brown","LF",493,1591,188,391,73,9,54,229,138,317,23,7,0.246,0.305,0.405,0.710734070587192,644,0.159,0.435331230283912,30,76.6666666666667,1729,417,0.305957200694043,0.404776869893149,29.462962962963
"D Rhodes","LF",576,1172,146,296,44,10,54,207,131,196,3,2,0.253,0.328,0.445,0.773097786939565,522,0.192,0.668367346938776,5,60,1303,353,0.327705295471988,0.445392491467577,21.7037037037037
"M Benard","CF",891,2630,441,714,138,21,54,260,265,454,105,43,0.271,0.343,0.402,0.73969016988777,1056,0.131,0.583700440528634,148,70.9459459459459,2895,701,0.338169257340242,0.401520912547529,48.7037037037037
"A Bumbry","CF",1496,5053,778,1422,220,52,54,402,471,709,254,92,0.281,0.343,0.378,0.720283925938993,1908,0.097,0.664315937940762,346,73.4104046242775,5524,1180,0.342686459087618,0.377597466851375,93.5740740740741
"D Buford","CF",699,1853,280,448,86,9,54,218,173,430,56,35,0.242,0.311,0.385,0.691836402003315,714,0.143,0.402325581395349,91,61.5384615384615,2026,498,0.306515301085884,0.385321100917431,34.3148148148148
"M Davidson","3B",311,1003,109,221,46,1,54,157,88,381,0,3,0.22,0.29,0.43,0.71293726519799,431,0.21,0.230971128608924,3,0,1091,266,0.283226397800183,0.429710867397807,18.5740740740741
"R Mejias","RF",627,1768,212,449,57,12,54,202,89,238,22,12,0.254,0.294,0.391,0.68111730836239,692,0.137,0.373949579831933,34,64.7058823529412,1857,414,0.289714593430264,0.391402714932127,32.7407407407407
"S Sax","2B",1769,6940,913,1949,278,47,54,550,556,584,444,178,0.281,0.335,0.358,0.691959208215563,2483,0.077,0.952054794520548,622,71.3826366559485,7496,1463,0.334178228388474,0.357780979827089,128.518518518519
"C Summers","RF",698,1371,199,350,63,4,54,218,188,244,15,13,0.255,0.35,0.425,0.770330061584485,583,0.17,0.770491803278688,28,53.5714285714286,1559,417,0.345093008338679,0.425237053245806,25.3888888888889
"J Walsh","1B",328,1131,136,283,61,6,54,173,86,340,4,2,0.25,0.308,0.458,0.761206369825643,518,0.208,0.252941176470588,6,66.6666666666667,1217,309,0.303204601479047,0.458001768346596,20.9444444444444
"W Randolph","2B",2202,8018,1239,2210,316,65,54,687,1243,675,271,94,0.276,0.373,0.351,0.724313120228433,2818,0.075,1.84148148148148,365,74.2465753424657,9261,1926,0.372853903466148,0.351459216762285,148.481481481481
"F Jose","RF",747,2527,322,708,135,14,54,324,203,507,102,57,0.28,0.334,0.409,0.742484754396112,1033,0.129,0.400394477317554,159,64.1509433962264,2730,646,0.333699633699634,0.408785120696478,46.7962962962963
"T Snider","LF",630,1783,214,435,100,7,54,212,167,492,22,11,0.244,0.311,0.399,0.707484073227203,711,0.155,0.339430894308943,33,66.6666666666667,1950,426,0.308717948717949,0.398766124509254,33.0185185185185
"B Phelps","C",726,2117,239,657,143,19,54,345,160,157,9,0,0.31,0.362,0.472,0.831172002209771,1000,0.162,1.01910828025478,9,100,2277,584,0.358805445761967,0.472366556447804,39.2037037037037
"A Rosario","SS",701,2684,350,735,114,35,54,277,123,561,82,29,0.274,0.308,0.403,0.708421489389152,1081,0.129,0.219251336898396,111,73.8738738738739,2807,627,0.305664410402565,0.402757078986587,49.7037037037037
"C Rojas","2B",1822,6309,714,1660,254,25,54,593,396,489,74,68,0.263,0.306,0.337,0.643615757185059,2126,0.074,0.809815950920245,142,52.112676056338,6705,1307,0.306636838180462,0.336978919004597,116.833333333333
"O Arcia","SS",645,2023,219,492,81,7,53,224,152,446,40,16,0.243,0.296,0.369,0.664851222436236,746,0.126,0.340807174887892,56,71.4285714285714,2175,443,0.296091954022988,0.368759268413248,38.1698113207547
"M Hegan","1B",966,2080,281,504,73,18,53,229,311,488,28,21,0.242,0.341,0.371,0.712015410352926,772,0.129,0.637295081967213,49,57.1428571428571,2391,510,0.34086156419908,0.371153846153846,39.2452830188679
"B Kielty","RF",599,1792,257,456,105,6,53,253,246,372,21,6,0.254,0.348,0.408,0.752937491237908,732,0.154,0.661290322580645,27,77.7777777777778,2038,510,0.344455348380765,0.408482142857143,33.811320754717
"C Michaels","2B",1288,4367,508,1142,147,46,53,501,566,406,64,32,0.262,0.349,0.353,0.698884447056553,1540,0.091,1.39408866995074,96,66.6666666666667,4933,1009,0.346239610784512,0.35264483627204,82.3962264150943
"J Ruggiano","CF",483,1340,164,343,72,4,53,163,114,394,40,25,0.256,0.318,0.434,0.748633722720647,582,0.178,0.289340101522843,65,61.5384615384615,1454,327,0.314305364511692,0.434328358208955,25.2830188679245
"M Parent","C",474,1303,112,279,50,0,53,168,98,319,3,3,0.214,0.268,0.375,0.643613842321815,488,0.161,0.307210031347962,6,50,1401,280,0.269093504639543,0.374520337682272,24.5849056603774
"B McPhee","2B",2135,8291,1678,2250,303,188,53,1067,981,229,568,0,0.271,0.355,0.372,0.720920563780658,3088,0.101,4.28384279475982,568,100,9272,2745,0.348468507333909,0.37245205644675,156.433962264151
"G Mancuso","C",1460,4505,386,1194,197,16,53,543,418,264,8,0,0.265,0.328,0.351,0.678607988099981,1582,0.086,1.58333333333333,8,100,4923,929,0.32744261629088,0.351165371809101,85
"M McLemore","2B",1832,6192,943,1602,255,47,53,614,875,983,272,119,0.259,0.349,0.341,0.691264608697337,2110,0.082,0.890132248219735,391,69.5652173913043,7067,1557,0.350502334795529,0.340762273901809,116.830188679245
"H Larkin","1B",1184,4718,925,1429,259,114,53,836,484,141,129,0,0.303,0.38,0.44,0.807548177821195,2075,0.137,3.43262411347518,129,100,5202,1761,0.367743175701653,0.439805002119542,89.0188679245283
"J Ray","2B",1353,5188,604,1502,294,36,53,594,353,329,80,49,0.29,0.333,0.391,0.725486445265315,2027,0.101,1.07294832826748,129,62.015503875969,5541,1198,0.334777116044035,0.39070932922128,97.8867924528302
"C Coghlan","LF",801,2580,353,666,149,26,53,234,275,535,47,23,0.258,0.334,0.398,0.727271616503075,1026,0.14,0.514018691588785,70,67.1428571428571,2855,587,0.329597197898424,0.397674418604651,48.6792452830189
"T Daly","2B",393,5684,1024,1582,262,103,49,811,687,402,385,0,0.278,0.361,0.387,0.742668607124273,2197,0.109,1.7089552238806,385,100,6371,1835,0.356145032177052,0.38652357494722,116
"D Walling","3B",1271,2945,372,799,142,30,49,380,308,316,44,18,0.271,0.339,0.39,0.730114503159419,1148,0.119,0.974683544303797,62,70.9677419354839,3253,752,0.340301260375038,0.38981324278438,60.1020408163265
"B Kauff","CF",569,3094,521,961,169,57,49,454,367,313,234,33,0.311,0.389,0.45,0.833283963686602,1391,0.139,1.17252396166134,267,87.6404494382023,3461,975,0.383704131753828,0.449579831932773,63.1428571428571
"P Suder","2B",1421,5085,469,1268,210,44,49,541,288,456,19,28,0.249,0.29,0.337,0.626469285134292,1713,0.088,0.631578947368421,47,40.4255319148936,5373,1010,0.289596128792109,0.336873156342183,103.775510204082
"D Roberts","3B",709,2017,194,483,77,7,49,208,128,361,27,8,0.239,0.286,0.357,0.642310061447394,721,0.118,0.354570637119114,35,77.1428571428572,2145,402,0.284848484848485,0.357461576598909,41.1632653061224
"T Shumpert","2B",854,1969,295,497,109,26,49,223,166,369,85,29,0.252,0.315,0.409,0.719375614768966,805,0.157,0.449864498644986,114,74.5614035087719,2135,518,0.310538641686183,0.408836973082783,40.1836734693878
"T Grisham","CF",398,1297,187,288,60,10,49,166,164,383,31,8,0.222,0.317,0.397,0.706447300858032,515,0.175,0.428198433420366,39,79.4871794871795,1461,353,0.309377138945927,0.397070161912105,26.469387755102
"R Arozarena","LF",339,1209,189,326,77,6,49,174,111,354,58,23,0.27,0.345,0.465,0.795907587036619,562,0.195,0.313559322033898,81,71.6049382716049,1320,363,0.331060606060606,0.464846980976013,24.6734693877551
"J Spivey","2B",457,1553,258,419,90,12,48,201,175,373,32,15,0.27,0.354,0.436,0.779680457179652,677,0.166,0.46916890080429,47,68.0851063829787,1728,459,0.34375,0.435930457179652,32.3541666666667
"S Wise","SS",1175,4715,834,1281,221,112,48,672,389,643,203,0,0.272,0.332,0.397,0.723800932128171,1870,0.125,0.6049766718507,203,100,5104,1506,0.327194357366771,0.3966065747614,98.2291666666667
"H Hendrick","1B",921,2910,434,896,157,46,48,413,239,243,75,0,0.308,0.364,0.443,0.803387209597985,1289,0.135,0.983539094650206,75,100,3149,847,0.360431883137504,0.442955326460481,60.625
"Y Tom?s","RF",309,1108,131,295,60,5,48,163,61,299,7,6,0.266,0.306,0.459,0.763920071152177,509,0.193,0.204013377926421,13,53.8461538461538,1169,294,0.30453378956373,0.459386281588448,23.0833333333333
"L Johnson","LF",678,2049,244,529,97,14,48,232,110,320,50,24,0.258,0.311,0.389,0.685428628974561,798,0.131,0.34375,74,67.5675675675676,2159,476,0.295970356646596,0.389458272327965,42.6875
"B Serena","3B",408,1239,154,311,57,16,48,198,177,235,2,2,0.251,0.348,0.439,0.783696529459241,544,0.188,0.753191489361702,4,50,1416,352,0.344632768361582,0.439063761097659,25.8125
"E Riles","SS",919,2504,309,637,92,20,48,284,244,409,20,28,0.254,0.319,0.365,0.685213411089564,913,0.111,0.596577017114914,48,41.6666666666667,2748,593,0.320596797671033,0.36461661341853,52.1666666666667
"E Flick","RF",1085,5597,950,1752,268,164,48,756,597,0,330,0,0.313,0.389,0.445,0.824476492867247,2492,0.132,Inf,330,100,6194,1706,0.379237972231191,0.445238520636055,116.604166666667
"M Fitzgerald","C",848,2316,220,545,95,9,48,293,292,432,31,20,0.235,0.321,0.346,0.667222284031067,802,0.111,0.675925925925926,51,60.7843137254902,2608,513,0.320935582822086,0.346286701208981,48.25
"M Margot","RF",691,2306,276,585,112,24,48,245,179,454,82,36,0.254,0.308,0.386,0.692960713107788,889,0.132,0.394273127753304,118,69.4915254237288,2485,521,0.307444668008048,0.38551604509974,48.0416666666667
"D Descalso","2B",1080,2519,326,593,126,25,48,294,303,600,26,15,0.235,0.32,0.362,0.679950730226325,913,0.127,0.505,41,63.4146341463415,2822,620,0.317505315379164,0.362445414847162,52.4791666666667
"F Fain","1B",1151,3930,595,1139,213,30,48,570,904,261,46,28,0.29,0.424,0.396,0.818560114372221,1556,0.106,3.46360153256705,74,62.1621621621622,4834,1165,0.42263136119156,0.395928753180662,81.875
"H Rice","CF",1034,3740,620,1118,186,63,48,506,376,194,59,55,0.299,0.368,0.421,0.783829375906207,1574,0.122,1.93814432989691,114,51.7543859649123,4116,1126,0.362973760932945,0.420855614973262,77.9166666666667
"J Busby","CF",1352,4250,541,1113,162,35,48,438,310,439,97,48,0.262,0.314,0.35,0.662414344685243,1489,0.088,0.706150341685649,145,66.8965517241379,4560,979,0.312061403508772,0.350352941176471,88.5416666666667
"B Estalella","C",310,904,126,195,49,5,48,147,130,290,6,2,0.216,0.315,0.44,0.754578832953904,398,0.224,0.448275862068966,8,75,1034,273,0.31431334622824,0.440265486725664,18.8333333333333
"R Peckinpaugh","SS",2012,7233,1007,1876,256,75,48,739,814,609,205,70,0.259,0.336,0.335,0.669693230962963,2426,0.076,1.33661740558292,275,74.5454545454545,8047,1746,0.334286069342612,0.335407161620351,150.6875
"T Hulett","3B",720,2128,245,529,90,13,48,220,145,438,14,11,0.249,0.298,0.371,0.667295093761681,789,0.122,0.331050228310502,25,56,2273,465,0.296524417069952,0.370770676691729,44.3333333333333
"J Francisco","3B",404,996,110,235,50,4,48,152,81,375,2,6,0.236,0.297,0.439,0.732162633822197,437,0.203,0.216,8,25,1077,262,0.293407613741876,0.438755020080321,20.75
"B Boesch","RF",481,1577,192,394,79,7,48,195,109,344,22,7,0.25,0.303,0.4,0.698466087613236,631,0.15,0.316860465116279,29,75.8620689655172,1686,387,0.298339264531435,0.400126823081801,32.8541666666667
"M Lewis","2B",902,2795,320,736,155,13,48,306,196,511,29,18,0.263,0.312,0.38,0.691207911151463,1061,0.117,0.383561643835616,47,61.7021276595745,2991,626,0.311601471079906,0.379606440071556,58.2291666666667
"D Jansen","C",325,954,137,212,44,1,48,144,104,217,1,1,0.222,0.307,0.421,0.720060396380973,402,0.199,0.47926267281106,2,50,1058,281,0.298676748582231,0.421383647798742,19.875
"K Johjima","C",462,1609,166,431,84,1,48,198,66,148,7,5,0.268,0.31,0.411,0.707530588202555,661,0.143,0.445945945945946,12,58.3333333333333,1675,364,0.296716417910448,0.410814170292107,33.5208333333333
"A Rosales","SS",653,1621,186,367,69,6,48,179,135,451,17,12,0.226,0.291,0.365,0.651083655720266,592,0.139,0.299334811529933,29,58.6206896551724,1756,365,0.285876993166287,0.365206662553979,33.7708333333333
"F Sanchez","2B",904,3402,434,1012,215,17,48,371,180,420,13,9,0.297,0.335,0.413,0.74576734347812,1405,0.116,0.428571428571429,22,59.0909090909091,3582,805,0.332774986041318,0.412992357436802,70.875
"E Sheely","1B",1235,4471,573,1340,244,27,48,747,563,205,33,31,0.3,0.383,0.399,0.776597952975904,1782,0.099,2.74634146341463,64,51.5625,5034,1320,0.37802940007946,0.398568552896444,93.1458333333333
"A Hays","CF",353,1286,178,333,74,6,48,162,80,278,11,10,0.259,0.311,0.438,0.740134208015593,563,0.179,0.287769784172662,21,52.3809523809524,1366,340,0.302342606149341,0.437791601866252,26.7916666666667
"J Alfaro","C",478,1542,150,395,67,4,47,194,70,566,18,5,0.256,0.305,0.396,0.684700189564003,611,0.14,0.123674911660777,23,78.2608695652174,1612,344,0.288461538461538,0.396238651102464,32.8085106382979
"B Herman","2B",1922,7707,1163,2345,486,82,47,839,737,428,67,0,0.304,0.367,0.407,0.771895709985023,3136,0.103,1.72196261682243,67,100,8444,2002,0.364992894362861,0.406902815622162,163.978723404255
"J Gantner","2B",1801,6189,726,1696,262,38,47,568,383,501,137,78,0.274,0.319,0.351,0.667772013586629,2175,0.077,0.764471057884232,215,63.7209302325581,6572,1294,0.316342057212416,0.351429956374212,131.68085106383
"J Lumpe","2B",1371,4912,620,1314,190,52,47,454,428,411,20,15,0.268,0.325,0.356,0.682284003708719,1749,0.088,1.04136253041363,35,57.1428571428571,5340,1074,0.326217228464419,0.3560667752443,104.510638297872
"G Smith","SS",1710,6552,907,1594,251,94,47,797,408,288,235,0,0.243,0.289,0.332,0.619450759968001,2174,0.089,1.41666666666667,235,100,6960,1704,0.28764367816092,0.331807081807082,139.404255319149
"D Berryhill","C",683,2030,175,488,106,6,47,257,139,409,3,6,0.24,0.288,0.368,0.657053601237318,747,0.128,0.339853300733496,9,33.3333333333333,2169,432,0.289073305670816,0.367980295566502,43.1914893617021
"B Haselman","C",589,1606,185,416,94,3,47,210,114,300,9,9,0.259,0.311,0.409,0.71723044397463,657,0.15,0.38,18,50,1720,395,0.308139534883721,0.409090909090909,34.1702127659574
"S Fasano","C",427,1109,136,245,49,0,47,140,72,327,2,3,0.221,0.295,0.392,0.660661862110406,435,0.171,0.220183486238532,5,40,1181,276,0.268416596104996,0.39224526600541,23.5957446808511
"P Masi","C",1229,3468,420,917,164,31,47,417,410,311,45,1,0.264,0.344,0.37,0.712428908705126,1284,0.106,1.31832797427653,46,97.8260869565217,3878,837,0.342186694172254,0.370242214532872,73.7872340425532
"J Harris","1B",972,3035,462,963,201,64,47,517,413,188,36,16,0.317,0.404,0.472,0.871230080614027,1433,0.155,2.1968085106383,52,69.2307692307692,3448,979,0.39907192575406,0.472158154859967,64.5744680851064
"F Schulte","CF",1179,4259,686,1241,249,54,47,593,462,361,56,58,0.291,0.362,0.408,0.769040469466481,1739,0.117,1.2797783933518,114,49.1228070175439,4721,1279,0.360728659182377,0.408311810284104,90.6170212765958
"C Essegian","LF",404,1018,139,260,45,4,47,150,97,233,0,0,0.255,0.323,0.446,0.766151867285718,454,0.191,0.416309012875536,0,0,1115,289,0.320179372197309,0.445972495088409,21.6595744680851
"G Metkovich","CF",1055,3585,476,934,167,36,47,373,307,359,61,28,0.261,0.322,0.367,0.685386395008321,1314,0.106,0.855153203342618,89,68.5393258426966,3892,849,0.318859198355601,0.36652719665272,76.2765957446808
"F Snyder","C",1391,4229,331,1122,170,44,47,525,281,416,37,20,0.265,0.313,0.36,0.670745968471314,1521,0.095,0.675480769230769,57,64.9122807017544,4510,856,0.311086474501109,0.359659493970206,89.9787234042553
"D Santana","OF",547,1740,254,443,89,23,47,202,90,478,75,26,0.255,0.296,0.413,0.704475221405691,719,0.158,0.188284518828452,101,74.2574257425743,1830,456,0.291256830601093,0.413218390804598,37.0212765957447
"L Brown","SS",1129,3449,331,803,108,13,47,254,317,414,22,23,0.233,0.3,0.313,0.609952133100376,1078,0.08,0.765700483091787,45,48.8888888888889,3766,585,0.297397769516729,0.312554363583647,73.3829787234042
"P Tabler","1B",1202,3911,454,1101,190,25,47,512,375,559,16,20,0.282,0.345,0.379,0.723308261167486,1482,0.097,0.670840787119857,36,44.4444444444444,4286,966,0.344377041530565,0.378931219636922,83.2127659574468
"F House","C",653,1994,202,494,64,11,47,235,151,147,6,7,0.248,0.302,0.362,0.662284054962089,721,0.114,1.02721088435374,13,46.1538461538462,2145,437,0.300699300699301,0.361584754262788,42.4255319148936
"L Cross","3B",847,9072,1333,2645,411,135,47,1371,464,90,301,0,0.292,0.328,0.382,0.708192587561995,3467,0.09,5.15555555555556,301,100,9536,2704,0.326027684563758,0.382164902998236,193.021276595745
"L Green","CF",1136,2956,461,788,138,27,47,253,368,260,78,41,0.267,0.351,0.379,0.727002453961756,1121,0.112,1.41538461538462,119,65.546218487395,3324,714,0.34777376654633,0.379228687415426,62.8936170212766
"C Casali","C",463,1182,137,263,56,1,47,148,145,378,2,2,0.223,0.315,0.391,0.698323381238548,462,0.168,0.383597883597884,4,50,1327,285,0.307460437076112,0.390862944162437,25.1489361702128
"D Robertson","RF",805,2830,366,812,117,44,47,364,113,262,94,57,0.287,0.318,0.409,0.723492409970836,1158,0.122,0.431297709923664,151,62.2516556291391,2943,730,0.314305130818892,0.409187279151943,60.2127659574468
"E Collins","2B",2825,9949,1821,3314,438,187,47,1300,1499,286,745,173,0.333,0.424,0.429,0.84931010663117,4267,0.096,5.24125874125874,918,81.1546840958606,11448,3121,0.420422781271838,0.428887325359333,211.68085106383
"M Thompson","CF",1359,3761,491,1029,156,37,47,357,336,635,214,66,0.274,0.335,0.372,0.705412037796282,1400,0.098,0.529133858267717,280,76.4285714285714,4097,848,0.333170612643398,0.372241425152885,80.0212765957447
"J Iglesias","SS",1096,3770,438,1051,220,14,47,366,173,502,59,35,0.279,0.319,0.382,0.692386400100638,1440,0.103,0.344621513944223,94,62.7659574468085,3943,804,0.310423535379153,0.381962864721485,80.2127659574468
"E Allen","CF",1281,4418,623,1325,255,45,47,501,223,310,84,4,0.3,0.336,0.41,0.743462792367008,1811,0.11,0.719354838709677,88,95.4545454545455,4641,1124,0.333548804137039,0.409913988229968,94
"A Cedeno","SS",616,2051,221,485,98,13,47,223,143,488,26,17,0.236,0.292,0.366,0.651910467224339,750,0.13,0.293032786885246,43,60.4651162790698,2194,444,0.286235186873291,0.365675280351048,43.6382978723404
"L Alicea","2B",1341,3971,551,1031,189,53,47,422,500,624,81,50,0.26,0.346,0.369,0.711857342381787,1467,0.109,0.801282051282051,131,61.8320610687023,4471,973,0.342428986803847,0.36942835557794,84.4893617021277
"W Smith","LF",691,1654,171,410,63,21,46,211,107,284,20,16,0.248,0.295,0.395,0.688383675044478,653,0.147,0.376760563380282,36,55.5555555555556,1761,382,0.293583191368541,0.394800483675937,35.9565217391304
"T Hall","C",686,2350,211,616,123,1,46,269,104,216,2,8,0.262,0.297,0.374,0.667441086198824,879,0.112,0.481481481481481,10,20,2454,480,0.293398533007335,0.374042553191489,51.0869565217391
"S Jolley","LF",473,1710,188,521,111,21,46,313,89,105,5,7,0.305,0.343,0.475,0.813931066316895,812,0.17,0.847619047619048,12,41.6666666666667,1799,501,0.339077265147304,0.474853801169591,37.1739130434783
"D Smith","LF",813,1807,244,497,88,20,46,226,150,334,42,37,0.275,0.333,0.422,0.752854891512284,763,0.147,0.449101796407186,79,53.1645569620253,1957,470,0.330608073582013,0.422246817930271,39.2826086956522
"G Hermanski","RF",739,1960,276,533,85,18,46,259,289,212,43,2,0.272,0.372,0.404,0.769577408553461,792,0.132,1.36320754716981,45,95.5555555555556,2249,535,0.3654957759004,0.404081632653061,42.6086956521739
"B Russell","SS",2181,7318,796,1926,293,57,46,627,483,667,167,69,0.263,0.31,0.338,0.646467126256474,2471,0.075,0.724137931034483,236,70.7627118644068,7801,1423,0.30880656326112,0.337660562995354,159.086956521739
"G Thomas","RF",685,1688,203,430,71,9,46,202,138,343,13,12,0.255,0.316,0.389,0.700280441023032,657,0.134,0.402332361516035,25,52,1826,405,0.311062431544359,0.389218009478673,36.695652173913
"H Foiles","C",608,1455,171,353,59,10,46,166,170,295,3,7,0.243,0.321,0.392,0.713598731165741,570,0.149,0.576271186440678,10,30,1625,337,0.321846153846154,0.391752577319588,31.6304347826087
"D Ackley","2B",635,2125,261,512,94,18,46,216,194,419,31,12,0.241,0.304,0.367,0.671500393171499,780,0.126,0.463007159904535,43,72.0930232558139,2319,477,0.304441569642087,0.367058823529412,46.195652173913
"J Stearns","C",810,2681,334,696,152,10,46,312,323,294,91,51,0.26,0.341,0.375,0.71444750279498,1006,0.115,1.09863945578231,142,64.0845070422535,3004,646,0.339214380825566,0.375233121969414,58.2826086956522
"C Tovar","CF",1488,5569,834,1546,253,55,46,435,413,410,226,108,0.278,0.335,0.368,0.695052926781782,2047,0.09,1.00731707317073,334,67.6646706586826,5982,1269,0.327482447342026,0.367570479439756,121.065217391304
"E Smith","C",863,2264,225,686,115,19,46,355,247,106,18,9,0.303,0.374,0.432,0.803102215974096,977,0.129,2.33018867924528,27,66.6666666666667,2511,580,0.371565113500597,0.431537102473498,49.2173913043478
"R Roberts","3B",518,1500,205,365,71,4,46,169,166,320,35,20,0.243,0.32,0.388,0.706727490996399,582,0.145,0.51875,55,63.6363636363636,1666,374,0.318727490996399,0.388,32.6086956521739
"A Ochoa","RF",807,2143,320,597,131,19,46,261,203,288,56,38,0.279,0.344,0.422,0.762844511701493,904,0.143,0.704861111111111,94,59.5744680851064,2346,581,0.341005967604433,0.42183854409706,46.5869565217391
"B Bell","RF",767,2718,378,806,165,32,46,437,272,239,11,12,0.297,0.362,0.432,0.792102445975178,1173,0.135,1.13807531380753,23,47.8260869565217,2990,815,0.360535117056856,0.431567328918322,59.0869565217391
"A Berroa","SS",746,2575,329,665,118,21,46,254,117,460,50,20,0.258,0.303,0.374,0.664470924277615,963,0.116,0.254347826086956,70,71.4285714285714,2692,583,0.290490341753343,0.373980582524272,55.9782608695652
"J Kang","3B",297,917,120,233,50,3,46,144,75,239,8,5,0.254,0.331,0.466,0.776132725929574,427,0.212,0.313807531380753,13,61.5384615384615,992,264,0.310483870967742,0.465648854961832,19.9347826086957
"P Browning","CF",1183,4820,954,1646,295,85,46,659,466,168,258,0,0.341,0.403,0.467,0.866143480861526,2249,0.126,2.77380952380952,258,100,5286,1613,0.399545970488082,0.466597510373444,104.782608695652
"S Murphy","C",332,1106,149,259,70,2,46,147,127,292,1,0,0.234,0.325,0.426,0.738916534305983,471,0.192,0.434931506849315,1,100,1233,296,0.313057583130576,0.425858951175407,24.0434782608696
"J McNeil","2B",521,1858,259,568,122,9,46,216,138,244,19,9,0.306,0.368,0.455,0.809035724840424,846,0.149,0.565573770491803,28,67.8571428571429,1996,475,0.353707414829659,0.455328310010764,40.3913043478261
"J Hopp","CF",1395,4260,698,1262,216,74,46,458,464,378,119,1,0.296,0.368,0.414,0.779452838964353,1764,0.118,1.22751322751323,120,99.1666666666667,4724,1156,0.3653683319221,0.414084507042254,92.6086956521739
"D Bragg","RF",916,2461,341,627,145,14,46,260,304,570,56,24,0.255,0.34,0.381,0.717854736419794,938,0.126,0.533333333333333,80,70,2765,601,0.336708860759494,0.381145875660301,53.5
"W Tasby","OF",583,1868,246,467,61,10,46,174,201,327,12,20,0.25,0.327,0.367,0.690098973011406,686,0.117,0.614678899082569,32,37.5,2069,420,0.322861285645239,0.367237687366167,40.6086956521739
"G Green","RF",408,1151,130,307,49,7,46,160,89,185,2,3,0.267,0.318,0.441,0.760710181889521,508,0.174,0.481081081081081,5,40,1240,290,0.319354838709677,0.441355343179844,25.0217391304348
"Do Smith","1B",450,1254,149,309,78,3,46,180,97,336,3,3,0.246,0.309,0.423,0.723963110791581,531,0.177,0.288690476190476,6,50,1351,329,0.300518134715026,0.423444976076555,27.2608695652174
"S Owen","SS",1544,4930,587,1211,215,59,46,439,569,519,82,62,0.246,0.324,0.341,0.664871687900474,1682,0.095,1.09633911368015,144,56.9444444444444,5499,1026,0.323695217312239,0.341176470588235,107.173913043478
"G Gore","CF",1310,5357,1327,1612,262,94,46,618,717,332,170,0,0.301,0.386,0.411,0.794115220967411,2200,0.11,2.15963855421687,170,100,6074,1945,0.383437602897596,0.410677618069815,116.45652173913
"B Sample","LF",826,2516,371,684,127,9,46,230,195,230,98,31,0.272,0.329,0.384,0.708574822354196,967,0.112,0.847826086956522,129,75.968992248062,2711,601,0.324234599778679,0.384340222575517,54.695652173913
"C Kusick","1B",497,1238,155,291,50,3,46,171,194,228,11,4,0.235,0.342,0.392,0.730448055522965,485,0.157,0.850877192982456,15,73.3333333333333,1432,326,0.338687150837989,0.391760904684976,26.9130434782609
"D Pavletich","C",536,1373,163,349,73,8,46,193,148,237,5,2,0.254,0.328,0.42,0.746278012175261,576,0.166,0.624472573839662,7,71.4285714285714,1521,356,0.326758711374096,0.419519300801165,29.8478260869565
"G Dobbs","3B",959,2097,204,548,106,9,46,274,132,402,14,6,0.261,0.306,0.386,0.691335632329977,810,0.125,0.328358208955224,20,70,2229,478,0.305069537909376,0.386266094420601,45.5869565217391
"D Kryhoski","1B",569,1794,203,475,85,14,45,231,119,163,5,13,0.265,0.314,0.403,0.713517090423384,723,0.138,0.730061349693252,18,27.7777777777778,1913,434,0.310507056978568,0.403010033444816,39.8666666666667
"M Kreevich","CF",1241,4676,676,1321,221,75,45,514,446,339,115,53,0.283,0.346,0.391,0.735700991613025,1827,0.108,1.31563421828909,168,68.4523809523809,5122,1190,0.344982428738774,0.390718562874251,103.911111111111
"J Turner","LF",733,1742,222,448,73,9,45,238,159,245,45,24,0.257,0.319,0.387,0.706217224483337,674,0.13,0.648979591836735,69,65.2173913043478,1901,460,0.319305628616518,0.38691159586682,38.7111111111111
"T Fuentes","2B",1499,5566,610,1491,211,46,45,438,298,561,80,47,0.268,0.307,0.347,0.651650306700347,1929,0.079,0.531194295900178,127,62.992125984252,5864,1048,0.305081855388813,0.346568451311534,123.688888888889
"B Myers","SS",738,2399,319,616,88,33,45,243,250,445,23,0,0.257,0.328,0.377,0.704156334171577,905,0.12,0.561797752808989,23,100,2649,562,0.326915817289543,0.377240516882034,53.3111111111111
"R Foster","LF",337,1016,136,257,51,1,45,118,110,146,9,6,0.253,0.336,0.438,0.763924630424749,445,0.185,0.753424657534247,15,60,1126,254,0.325932504440497,0.437992125984252,22.5777777777778
"S Halter","SS",690,1899,201,468,93,18,45,197,146,414,17,21,0.246,0.303,0.385,0.68571053353264,732,0.139,0.352657004830918,38,44.7368421052632,2045,398,0.300244498777506,0.385466034755134,42.2
"B Stein","3B",959,2811,268,751,122,18,44,311,186,412,16,16,0.267,0.313,0.37,0.682976822428975,1041,0.103,0.451456310679612,32,50,2997,579,0.312645979312646,0.370330843116329,63.8863636363636
"E Miksis","2B",1042,3053,383,722,95,17,44,228,215,313,52,22,0.236,0.288,0.322,0.608698088161774,983,0.086,0.686900958466454,74,70.2702702702703,3268,611,0.28671970624235,0.321978381919424,69.3863636363636
"D Murphy","2B",1417,5399,705,1563,289,102,44,702,335,24,193,0,0.289,0.336,0.405,0.736268255699537,2188,0.116,13.9583333333333,193,100,5734,1407,0.331008022322986,0.405260233376551,122.704545454545
"B Estalella","CF",680,2196,279,620,106,33,44,308,350,246,13,17,0.282,0.383,0.421,0.801754815224997,924,0.139,1.42276422764228,30,43.3333333333333,2546,587,0.380989787902592,0.420765027322404,49.9090909090909
"O Arcia","RF",288,983,103,231,40,6,44,131,76,339,3,5,0.235,0.298,0.422,0.712073137578687,415,0.187,0.224188790560472,8,37.5,1059,234,0.289896128423041,0.422177009155646,22.3409090909091
"J Burns","1B",890,3506,541,980,199,31,44,417,376,299,63,47,0.28,0.351,0.392,0.740918857582189,1373,0.112,1.25752508361204,110,57.2727272727273,3882,958,0.349304482225657,0.391614375356532,79.6818181818182
"J Marty","CF",538,1832,223,478,78,22,44,222,142,187,14,0,0.261,0.318,0.4,0.713646398817819,732,0.139,0.759358288770054,14,100,1974,445,0.314083080040527,0.399563318777293,41.6363636363636
"K Lockhart","2B",979,2268,290,591,117,17,44,268,195,268,30,15,0.261,0.319,0.385,0.704484572734674,874,0.124,0.727611940298508,45,66.6666666666667,2463,558,0.319123020706456,0.385361552028219,51.5454545454545
"D Taylor","OF",675,2190,388,650,121,37,44,305,267,268,56,2,0.297,0.374,0.446,0.81933809468056,977,0.149,0.996268656716418,58,96.551724137931,2457,693,0.373219373219373,0.446118721461187,49.7727272727273
"J Kindall","2B",742,2057,211,439,83,9,44,198,145,535,17,11,0.213,0.266,0.327,0.59190279575248,672,0.114,0.271028037383178,28,60.7142857142857,2202,409,0.265213442325159,0.326689353427321,46.75
"D Motley","RF",413,1333,156,324,60,10,44,159,67,186,19,22,0.243,0.28,0.402,0.681386239416997,536,0.159,0.360215053763441,41,46.3414634146341,1400,315,0.279285714285714,0.402100525131283,30.2954545454545
"E Averill","C",449,1031,137,249,41,0,44,159,162,220,3,3,0.242,0.346,0.409,0.75382098776975,422,0.167,0.736363636363636,6,50,1193,296,0.344509639564124,0.409311348205626,23.4318181818182
"A Ellis","C",672,1948,194,466,82,3,44,229,280,414,2,4,0.239,0.34,0.352,0.686985500941904,686,0.113,0.676328502415459,6,33.3333333333333,2228,423,0.334829443447038,0.352156057494867,44.2727272727273
"T Howard","LF",1015,2483,297,655,123,22,44,264,165,432,66,41,0.264,0.311,0.384,0.693880319708763,954,0.12,0.381944444444444,107,61.6822429906542,2648,561,0.309667673716012,0.384212645992751,56.4318181818182
"L Mann","LF",1365,4716,677,1332,203,106,44,503,324,464,129,21,0.282,0.332,0.398,0.727002302193142,1879,0.116,0.698275862068966,150,86,5040,1180,0.328571428571429,0.398430873621713,107.181818181818
"T Pagnozzi","C",927,2896,247,733,153,11,44,320,189,450,18,21,0.253,0.299,0.359,0.657981500219383,1040,0.106,0.42,39,46.1538461538462,3085,567,0.298865478119935,0.359116022099448,65.8181818181818
"H Craft","CF",566,2104,237,533,85,25,44,267,110,203,14,0,0.253,0.294,0.38,0.670652707794505,800,0.127,0.541871921182266,14,100,2214,504,0.290424570912376,0.380228136882129,47.8181818181818
"H Cotto","CF",884,2178,296,569,87,9,44,210,107,352,130,26,0.261,0.299,0.37,0.665906729921053,806,0.109,0.303977272727273,156,83.3333333333333,2285,506,0.295842450765864,0.370064279155188,49.5
"P Reese","2B",856,2833,366,704,128,17,44,271,226,531,144,26,0.248,0.307,0.352,0.656297660309709,998,0.104,0.425612052730697,170,84.7058823529412,3059,637,0.304020921869892,0.352276738439816,64.3863636363636
"J Clark","LF",516,1609,170,414,79,16,44,208,83,295,17,8,0.257,0.301,0.408,0.70206337871929,657,0.151,0.28135593220339,25,68,1692,378,0.293735224586288,0.408328154133002,36.5681818181818
"G Cimoli","RF",969,3054,370,808,133,48,44,321,221,474,21,6,0.265,0.315,0.383,0.696975159595475,1169,0.118,0.466244725738397,27,77.7777777777778,3275,691,0.314198473282443,0.382776686313032,69.4090909090909
"L Blue","1B",1615,5904,1151,1696,319,109,44,695,1092,436,151,85,0.287,0.402,0.401,0.799089317008093,2365,0.114,2.5045871559633,236,63.9830508474576,6996,1846,0.398513436249285,0.400575880758808,134.181818181818
"A Frazier","2B",824,2759,379,756,152,25,44,259,229,389,42,28,0.274,0.337,0.395,0.724722618879529,1090,0.121,0.588688946015424,70,60,2988,638,0.329651941097724,0.395070677781805,62.7045454545455
"W Middlebrooks","3B",347,1150,119,262,51,4,43,155,64,325,10,4,0.228,0.272,0.391,0.659838120478476,450,0.163,0.196923076923077,14,71.4285714285714,1214,274,0.268533772652389,0.391304347826087,26.7441860465116
"J Quirk","C",984,2266,193,544,100,7,43,247,177,435,5,16,0.24,0.298,0.347,0.642436971602131,787,0.107,0.406896551724138,21,23.8095238095238,2443,440,0.29512893982808,0.347308031774051,52.6976744186046
"D Thomas","2B",1597,4677,585,1163,154,54,43,370,456,593,140,92,0.249,0.317,0.332,0.647674363533598,1554,0.083,0.768971332209106,232,60.3448275862069,5133,955,0.315410091564387,0.332264271969211,108.767441860465
"P Bourjos","CF",875,2116,284,502,91,37,43,170,134,562,68,32,0.237,0.293,0.376,0.658848141146818,796,0.139,0.238434163701068,100,68,2250,454,0.282666666666667,0.376181474480151,49.2093023255814
"D Pratt","2B",1836,6826,859,1996,392,117,43,968,513,360,247,108,0.292,0.345,0.403,0.744890062510762,2751,0.111,1.425,355,69.5774647887324,7339,1827,0.341872189671617,0.403017872839144,158.744186046512
"S Amoros","LF",517,1311,215,334,55,23,43,180,211,189,18,15,0.255,0.361,0.43,0.788287421404451,564,0.175,1.11640211640212,33,54.5454545454545,1522,395,0.3580814717477,0.430205949656751,30.4883720930233
"P Roof","C",857,2151,190,463,69,13,43,210,184,504,11,10,0.215,0.283,0.319,0.596474126371181,687,0.104,0.365079365079365,21,52.3809523809524,2335,400,0.277087794432548,0.319386331938633,50.0232558139535
"S Duncan","LF",330,885,117,200,42,0,43,144,97,243,2,3,0.226,0.305,0.419,0.721653031401383,371,0.193,0.39917695473251,5,40,982,261,0.302443991853361,0.419209039548023,20.5813953488372
"R Weatherly","OF",811,2781,415,794,152,44,43,290,180,170,42,49,0.286,0.331,0.418,0.747137818610655,1163,0.132,1.05882352941176,91,46.1538461538462,2961,705,0.328942924687606,0.418194893923049,64.6744186046512
"M Keough","CF",841,1796,256,434,71,23,43,176,164,318,26,19,0.242,0.309,0.379,0.683721194491159,680,0.137,0.515723270440252,45,57.7777777777778,1960,432,0.305102040816327,0.378619153674833,41.7674418604651
"M Haas","CF",1168,4303,706,1257,254,45,43,496,433,299,12,16,0.292,0.359,0.402,0.758886301040757,1730,0.11,1.44816053511706,28,42.8571428571429,4736,1202,0.356841216216216,0.402045084824541,100.06976744186
"J Mart?nez","OF",432,1244,170,360,61,3,43,182,128,274,7,3,0.289,0.356,0.447,0.802630468815914,556,0.158,0.467153284671533,10,70,1372,352,0.355685131195335,0.446945337620579,28.9302325581395
"A Howe","3B",891,2626,268,682,139,23,43,293,275,287,10,10,0.26,0.329,0.379,0.709170328376406,996,0.119,0.958188153310105,20,50,2901,561,0.329886246122027,0.379284082254379,61.0697674418605
"R Dauer","2B",1140,3829,448,984,193,3,43,372,297,219,6,13,0.257,0.31,0.343,0.653118400066234,1312,0.086,1.35616438356164,19,31.5789473684211,4126,820,0.31047018904508,0.342648211021154,89.046511627907
"A Dalrymple","LF",951,4172,813,1202,217,81,43,407,204,359,58,0,0.288,0.323,0.41,0.731173348570868,1710,0.122,0.568245125348189,58,100,4376,1220,0.321297989031079,0.409875359539789,97.0232558139535
"J Morrill","1B",1265,4912,821,1275,239,80,43,643,358,656,61,0,0.26,0.31,0.367,0.676927433261841,1803,0.107,0.545731707317073,61,100,5270,1464,0.309867172675522,0.367060260586319,114.232558139535
"T Joseph","1B",249,810,98,200,42,1,43,116,55,204,2,1,0.247,0.297,0.46,0.755291515021766,373,0.213,0.269607843137255,3,66.6666666666667,865,214,0.294797687861272,0.460493827160494,18.8372093023256
"B Jurges","SS",1816,6253,721,1613,245,55,43,656,568,530,36,0,0.258,0.325,0.335,0.655106865227195,2097,0.077,1.07169811320755,36,100,6821,1377,0.319747837560475,0.33535902766672,145.418604651163
"C Kelly","C",415,1174,145,262,57,1,43,157,135,273,2,0,0.223,0.309,0.383,0.686589890718561,450,0.16,0.494505494505495,2,100,1309,302,0.303284950343774,0.383304940374787,27.3023255813953
"R Rivera","C",542,1492,120,330,65,2,43,176,93,446,1,1,0.221,0.273,0.354,0.62076437107264,528,0.133,0.208520179372197,2,50,1585,296,0.266876971608833,0.353887399463807,34.6976744186046
"P Bodie","CF",1051,3670,393,1011,169,72,43,516,312,240,83,26,0.275,0.335,0.396,0.728157909502845,1453,0.121,1.3,109,76.1467889908257,3982,909,0.332245102963335,0.39591280653951,85.3488372093023
"O Bluege","3B",1867,6440,883,1751,276,67,43,848,723,515,140,87,0.272,0.352,0.356,0.700976073559519,2290,0.084,1.40388349514563,227,61.6740088105727,7163,1731,0.345386011447717,0.355590062111801,149.767441860465
"W Chamberlain","RF",385,1263,144,322,72,6,43,167,77,249,20,7,0.255,0.299,0.424,0.721355810023517,535,0.169,0.309236947791165,27,74.0740740740741,1340,311,0.297761194029851,0.423594615993666,29.3720930232558
"T Tucker","1B",1687,6479,1084,1882,240,85,42,932,479,223,352,0,0.29,0.364,0.373,0.712527385777412,2418,0.083,2.14798206278027,352,100,6958,2016,0.339321644150618,0.373205741626794,154.261904761905
"R Radcliff","LF",1081,4074,598,1267,205,50,42,533,310,141,40,30,0.311,0.362,0.417,0.776506549455511,1698,0.106,2.19858156028369,70,57.1428571428571,4384,1131,0.359717153284672,0.416789396170839,97
"J Garagiola","C",676,1872,198,481,82,16,42,255,267,173,5,2,0.257,0.354,0.385,0.734845692331667,721,0.128,1.54335260115607,7,71.4285714285714,2139,453,0.349696119682094,0.385149572649573,44.5714285714286
"M Gallego","2B",1111,2931,374,700,111,12,42,282,326,465,24,31,0.239,0.32,0.328,0.642888261977169,961,0.089,0.701075268817204,55,43.6363636363636,3257,656,0.315013816395456,0.327874445581713,69.7857142857143
"E Milner","CF",804,2395,376,607,111,28,42,195,286,280,145,72,0.253,0.333,0.376,0.708867550901379,900,0.123,1.02142857142857,217,66.8202764976959,2681,571,0.333084669899291,0.375782881002088,57.0238095238095
"M Dominguez","3B",362,1272,123,294,48,2,42,152,66,249,0,2,0.231,0.273,0.371,0.640127478354063,472,0.14,0.265060240963855,2,0,1338,275,0.269058295964126,0.371069182389937,30.2857142857143
"J Cronenworth","2B",368,1340,210,341,78,14,42,179,144,255,10,4,0.254,0.336,0.428,0.754431347306594,573,0.174,0.564705882352941,14,71.4285714285714,1484,389,0.326819407008086,0.427611940298507,31.9047619047619
"C Heathcote","RF",1418,4443,643,1222,206,55,42,448,367,325,191,75,0.275,0.333,0.375,0.704875149912287,1664,0.1,1.12923076923077,266,71.8045112781955,4810,1091,0.33035343035343,0.374521719558857,105.785714285714
"J Panik","2B",818,2778,340,733,136,19,42,258,256,314,22,7,0.264,0.328,0.372,0.697822565757033,1033,0.108,0.815286624203822,29,75.8620689655172,3034,598,0.325972313777192,0.371850251979842,66.1428571428571
"J Estrada","C",612,2079,198,576,129,0,42,285,103,228,0,0,0.277,0.317,0.4,0.710893801177944,831,0.123,0.451754385964912,0,0,2182,483,0.311182401466544,0.3997113997114,49.5
"R Oester","2B",1276,4214,458,1118,190,33,42,344,369,681,40,26,0.265,0.323,0.356,0.680416296747198,1500,0.091,0.541850220264317,66,60.6060606060606,4583,802,0.324459960724416,0.355956336022781,100.333333333333
"E D?az","C",491,1518,167,368,79,3,42,186,116,297,1,2,0.242,0.297,0.381,0.677628555256143,579,0.139,0.390572390572391,3,33.3333333333333,1634,353,0.296205630354957,0.381422924901186,36.1428571428571
"S Podsednik","LF",1079,3906,563,1096,178,41,42,312,333,630,309,104,0.281,0.339,0.379,0.716524091087477,1482,0.098,0.528571428571429,413,74.818401937046,4239,875,0.337107808445388,0.379416282642089,93
"A Thomas","SS",577,2103,182,493,76,4,42,228,59,301,22,18,0.234,0.255,0.334,0.589603504618529,703,0.1,0.196013289036545,40,55,2162,410,0.25531914893617,0.334284355682359,50.0714285714286
"R Youngs","OF",1211,4627,812,1491,236,93,42,592,550,390,153,83,0.322,0.399,0.441,0.834918073527576,2039,0.119,1.41025641025641,236,64.8305084745763,5177,1404,0.394243770523469,0.440674303004106,110.166666666667
"J Dugan","3B",1448,5410,665,1516,277,46,42,571,250,419,37,28,0.28,0.317,0.372,0.683733173092624,2011,0.092,0.596658711217184,65,56.9230769230769,5660,1236,0.312014134275618,0.371719038817006,128.809523809524
"D Paskert","CF",1717,6017,868,1613,279,77,42,577,715,659,293,43,0.268,0.35,0.361,0.706788282871733,2172,0.093,1.08497723823976,336,87.2023809523809,6732,1445,0.345811051693405,0.360977231178328,143.261904761905
"R Spilborghs","LF",619,1561,222,424,86,12,42,218,172,328,31,19,0.272,0.345,0.423,0.76671818448307,660,0.151,0.524390243902439,50,62,1733,440,0.343912290825159,0.422805893657912,37.1666666666667
"N Goodrum","2B",402,1375,173,311,76,11,42,152,138,479,46,13,0.226,0.299,0.389,0.685852310280598,535,0.163,0.288100208768267,59,77.9661016949153,1513,325,0.296761401189689,0.389090909090909,32.7380952380952
"J Nunnally","RF",364,885,162,218,47,12,42,125,146,239,19,12,0.246,0.354,0.469,0.821981839802287,415,0.223,0.610878661087866,31,61.2903225806452,1031,287,0.353055286129971,0.468926553672316,21.0714285714286
"B Del Greco","CF",731,1982,271,454,95,11,42,169,271,372,16,15,0.229,0.33,0.352,0.673458149533104,697,0.123,0.728494623655914,31,51.6129032258064,2253,440,0.32179316466933,0.351664984863774,47.1904761904762
"D Dahl","OF",329,1148,168,311,64,14,42,160,76,326,17,8,0.271,0.317,0.461,0.776977864316458,529,0.19,0.233128834355828,25,68,1224,328,0.316176470588235,0.460801393728223,27.3333333333333
"G Wright","CF",627,2160,231,529,88,18,42,208,126,314,19,29,0.245,0.288,0.361,0.647174832312628,779,0.116,0.401273885350318,48,39.5833333333333,2286,439,0.286526684164479,0.360648148148148,51.4285714285714
"B Rogell","SS",1484,5149,755,1375,256,75,42,609,649,416,82,62,0.267,0.351,0.37,0.719449069002772,1907,0.103,1.56009615384615,144,56.9444444444444,5798,1364,0.349085891686789,0.370363177315984,122.595238095238
"M Sweeney","LF",1218,1830,220,464,101,9,42,250,259,425,16,9,0.254,0.347,0.387,0.73353030576504,709,0.133,0.609411764705882,25,64,2089,470,0.346098611775969,0.387431693989071,43.5714285714286
"M Griffin","CF",1511,5914,1405,1753,313,108,42,719,809,206,473,0,0.296,0.388,0.407,0.788249303530584,2408,0.111,3.92718446601942,473,100,6723,2124,0.381079875055779,0.407169428474806,140.809523809524
"T Crowley","DH",865,1518,174,379,62,1,42,229,222,181,3,0,0.25,0.345,0.375,0.720237608468493,569,0.125,1.22651933701657,3,100,1740,403,0.345402298850575,0.374835309617918,36.1428571428571
"E Inciarte","OF",868,3125,447,875,138,28,42,263,239,447,118,45,0.28,0.333,0.382,0.71355338882283,1195,0.102,0.534675615212528,163,72.3926380368098,3364,710,0.33115338882283,0.3824,74.4047619047619
"C Counsell","2B",1624,4741,647,1208,218,40,42,390,589,663,103,49,0.255,0.342,0.344,0.681379392493648,1632,0.089,0.888386123680241,152,67.7631578947368,5330,1037,0.337148217636023,0.344231174857625,112.880952380952
"M Pi?a","C",414,1114,132,271,55,2,42,148,94,258,4,1,0.243,0.313,0.409,0.71148804499031,456,0.166,0.364341085271318,5,80,1208,280,0.302152317880795,0.409335727109515,26.5238095238095
"K Fukudome","RF",596,1929,264,498,111,13,42,195,307,402,29,29,0.258,0.359,0.395,0.754522813919176,761,0.137,0.763681592039801,58,50,2236,459,0.360017889087657,0.394504924831519,45.9285714285714
"D Magadan","3B",1582,4159,516,1197,218,13,42,495,718,546,11,11,0.288,0.39,0.377,0.76943268457924,1567,0.089,1.31501831501832,22,50,4877,1011,0.392659421775682,0.376773262803559,99.0238095238095
"R Sanders","1B",630,2182,321,597,114,19,42,329,328,216,8,0,0.274,0.37,0.401,0.7695341457269,875,0.127,1.51851851851852,8,100,2510,650,0.368525896414343,0.401008249312557,51.9523809523809
"D McGann","1B",986,5222,842,1482,181,100,42,727,429,10,282,0,0.284,0.364,0.381,0.719058783805444,1989,0.097,42.9,282,100,5651,1569,0.338170235356574,0.38088854844887,124.333333333333
"C Reynolds","SS",1491,4466,480,1142,143,65,42,377,227,406,58,32,0.256,0.291,0.345,0.636762559247992,1541,0.089,0.559113300492611,90,64.4444444444444,4693,857,0.291711059024078,0.345051500223914,106.333333333333
"R Snyder","LF",1365,3631,488,984,150,29,42,319,294,438,58,32,0.271,0.325,0.363,0.68859049901152,1318,0.092,0.671232876712329,90,64.4444444444444,3925,807,0.325605095541401,0.362985403470118,86.4523809523809
"D Jones","2B",907,2329,268,548,91,19,41,237,191,309,20,13,0.235,0.295,0.343,0.636749030512448,800,0.108,0.618122977346278,33,60.6060606060606,2520,505,0.293253968253968,0.34349506225848,56.8048780487805
"J Maxwell","RF",441,1057,145,233,48,9,41,133,115,371,28,10,0.22,0.303,0.399,0.696171468610046,422,0.179,0.309973045822102,38,73.6842105263158,1172,278,0.296928327645051,0.399243140964995,25.780487804878
"A Aquino","RF",244,686,87,145,28,1,41,108,66,255,12,5,0.211,0.285,0.434,0.714987438744495,298,0.223,0.258823529411765,17,70.5882352941177,752,195,0.280585106382979,0.434402332361516,16.7317073170732
"B Gardner","2B",1034,3544,356,841,159,18,41,271,246,439,19,22,0.237,0.292,0.327,0.6138389905716,1159,0.09,0.560364464692483,41,46.3414634146341,3790,627,0.286807387862797,0.327031602708804,86.4390243902439
"M Bishop","2B",1340,4494,966,1216,236,35,41,379,1153,452,43,50,0.271,0.423,0.366,0.785558400319526,1645,0.095,2.55088495575221,93,46.2365591397849,5647,1345,0.419514786612361,0.366043613707165,109.609756097561
"D Mitchell","LF",1127,3984,555,1244,169,61,41,403,346,119,45,47,0.312,0.368,0.416,0.783370201359711,1658,0.104,2.90756302521008,92,48.9130434782609,4330,958,0.367205542725173,0.416164658634538,97.1707317073171
"R Stennett","2B",1237,4521,500,1239,177,41,41,432,207,348,75,54,0.274,0.306,0.359,0.664386557037267,1621,0.085,0.594827586206897,129,58.1395348837209,4728,932,0.305837563451777,0.35854899358549,110.268292682927
"B Rigney","2B",655,1966,281,510,78,14,41,212,208,206,25,4,0.259,0.334,0.376,0.706156921576647,739,0.117,1.00970873786408,29,86.2068965517241,2174,493,0.330266789328427,0.37589013224822,47.9512195121951
"B Fordyce","C",623,1807,172,467,103,4,41,188,119,295,8,6,0.258,0.309,0.388,0.692193333758586,701,0.13,0.403389830508475,14,57.1428571428571,1926,360,0.304257528556594,0.387935805201992,44.0731707317073
"M Aldrete","1B",930,2147,277,565,104,9,41,271,314,381,19,18,0.263,0.356,0.377,0.734442491502748,810,0.114,0.824146981627297,37,51.3513513513513,2461,548,0.357171881349045,0.377270610153703,52.3658536585366
"W Wilson","OF",2154,7731,1169,2207,281,147,41,585,425,1144,668,134,0.285,0.326,0.376,0.698467136980732,2905,0.091,0.371503496503497,802,83.2917705735661,8156,1754,0.322707209416381,0.375759927564351,188.560975609756
"M Cairo","2B",1490,3956,504,1044,193,34,41,394,243,482,139,40,0.264,0.314,0.361,0.667472225439588,1428,0.097,0.504149377593361,179,77.6536312849162,4199,898,0.306501547987616,0.360970677451972,96.4878048780488
"R Schu","3B",580,1568,189,386,67,13,41,134,139,282,17,16,0.246,0.31,0.384,0.691485689179011,602,0.138,0.49290780141844,33,51.5151515151515,1707,323,0.307557117750439,0.383928571428571,38.2439024390244
"G Burns","LF",1853,7241,1188,2077,362,108,41,611,872,565,383,139,0.287,0.366,0.384,0.74713936125913,2778,0.097,1.54336283185841,522,73.3716475095785,8113,1799,0.363490693947985,0.383648667311145,176.609756097561
"D Stapleton","1B",582,2028,238,550,118,8,41,224,114,162,6,11,0.271,0.31,0.398,0.70791965701468,807,0.127,0.703703703703704,17,35.2941176470588,2142,462,0.309990662931839,0.39792899408284,49.4634146341463
"F Dunlap","2B",965,3974,759,1159,224,53,41,366,283,263,85,0,0.292,0.34,0.406,0.744372837349277,1612,0.114,1.07604562737643,85,100,4257,1125,0.338736199201315,0.405636638147962,96.9268292682927
"D Buddin","SS",711,2289,342,551,123,12,41,225,410,404,15,8,0.241,0.358,0.359,0.714729708315508,821,0.118,1.01485148514851,23,65.2173913043478,2699,567,0.356057799184883,0.358671909130625,55.8292682926829
"D Varsho","LF",286,928,138,217,46,7,41,123,90,250,26,7,0.234,0.306,0.431,0.732606191992412,400,0.197,0.36,33,78.7878787878788,1018,261,0.301571709233792,0.431034482758621,22.6341463414634
"B Bryan","C",374,968,86,209,32,9,41,125,91,283,0,1,0.216,0.284,0.395,0.677914218153724,382,0.179,0.321554770318021,1,0,1059,211,0.28328611898017,0.394628099173554,23.609756097561
"F Welch","OF",738,2310,310,634,100,31,41,295,250,225,18,28,0.274,0.35,0.398,0.743147997835498,919,0.124,1.11111111111111,46,39.1304347826087,2560,605,0.3453125,0.397835497835498,56.3414634146341
"C Denorfia","RF",808,2162,289,587,103,17,41,196,187,408,56,20,0.272,0.33,0.392,0.721268798225001,847,0.12,0.458333333333333,76,73.6842105263158,2349,485,0.329501915708812,0.391766882516189,52.7317073170732
"F Cervelli","C",730,2256,281,605,102,16,41,275,270,505,17,13,0.268,0.358,0.382,0.728489664931521,862,0.114,0.534653465346535,30,56.6666666666667,2526,556,0.34639746634996,0.38209219858156,55.0243902439024
"F Patek","SS",1650,5530,736,1340,216,55,41,490,523,787,385,131,0.242,0.309,0.324,0.631289402920376,1789,0.082,0.664548919949174,516,74.6124031007752,6053,1226,0.307781265488188,0.323508137432188,134.878048780488
"M Stassi","C",403,1137,136,241,42,2,41,128,119,379,0,0,0.212,0.295,0.361,0.647222268905209,410,0.149,0.313984168865435,0,0,1256,264,0.286624203821656,0.360598065083553,27.7317073170732
"W Bond","1B",365,1199,149,307,40,11,41,179,106,175,10,4,0.256,0.323,0.41,0.726817047411796,492,0.154,0.605714285714286,14,71.4285714285714,1305,328,0.316475095785441,0.410341951626355,29.2439024390244
"H Chiti","C",502,1495,135,356,49,9,41,179,115,242,4,7,0.238,0.294,0.365,0.65776397515528,546,0.127,0.475206611570248,11,36.3636363636364,1610,314,0.292546583850932,0.365217391304348,36.4634146341463
"J Castino","3B",666,2320,293,646,86,34,41,249,177,298,22,19,0.278,0.329,0.398,0.727440342203748,923,0.12,0.593959731543624,41,53.6585365853659,2497,542,0.329595514617541,0.397844827586207,56.5853658536585
"B Wallace","1B",494,1284,143,305,68,3,40,138,119,432,2,2,0.238,0.316,0.389,0.69083883445132,499,0.151,0.275462962962963,4,50,1403,281,0.302209550962224,0.388629283489097,32.1
"B Henline","C",741,2101,258,611,96,21,40,268,192,156,18,10,0.291,0.361,0.414,0.763808814899889,869,0.123,1.23076923076923,28,64.2857142857143,2293,526,0.350196249454863,0.413612565445026,52.525
"A Dickerson","LF",339,902,136,230,49,8,40,132,81,204,7,2,0.255,0.325,0.46,0.776467125163252,415,0.205,0.397058823529412,9,77.7777777777778,983,268,0.316378433367243,0.460088691796009,22.55
"J Smith","OF",1408,4532,783,1301,182,71,40,382,334,348,228,67,0.287,0.339,0.385,0.72104464974648,1745,0.098,0.959770114942529,295,77.2881355932203,4866,1165,0.336004932182491,0.385039717563989,113.3
"R Cedeno","SS",875,2565,265,629,116,20,40,239,146,567,39,25,0.245,0.289,0.353,0.638698882539765,905,0.108,0.257495590828924,64,60.9375,2711,504,0.285872371818517,0.352826510721248,64.125
"H Ferris","2B",1279,4800,473,1146,192,89,40,550,161,0,89,0,0.239,0.265,0.341,0.604288281932406,1636,0.102,Inf,89,100,4961,1023,0.263454948599073,0.340833333333333,120
"I Flagstead","CF",1219,4139,645,1202,262,50,40,450,467,288,71,58,0.29,0.37,0.407,0.769215012782575,1684,0.117,1.62152777777778,129,55.0387596899225,4606,1095,0.362353452019106,0.406861560763469,103.475
"C Fernandez","SS",856,2778,270,666,91,19,40,259,213,338,68,28,0.24,0.292,0.329,0.623255295042796,915,0.089,0.630177514792899,96,70.8333333333333,2991,529,0.293881644934804,0.329373650107991,69.45
"B Klaus","SS",821,2513,357,626,106,15,40,250,331,285,14,7,0.249,0.335,0.351,0.687472820657476,882,0.102,1.16140350877193,21,66.6666666666667,2844,607,0.336497890295359,0.350974930362117,62.825
"K O'Dea","C",832,2195,262,560,101,20,40,323,273,251,3,0,0.255,0.338,0.374,0.711552149979879,821,0.119,1.08764940239044,3,100,2468,585,0.337520259319287,0.374031890660592,54.875
"J Royster","3B",1428,4208,552,1049,165,33,40,352,411,534,189,95,0.249,0.315,0.333,0.64878535261447,1400,0.084,0.769662921348315,284,66.5492957746479,4619,904,0.316085732842607,0.332699619771863,105.2
"E P?rez","C",564,1525,137,386,85,2,40,172,84,234,1,4,0.253,0.297,0.39,0.682270833121071,595,0.137,0.358974358974359,5,20,1609,309,0.292106898694842,0.390163934426229,38.125
"F Vina","2B",1148,4240,627,1196,194,49,40,343,288,292,116,67,0.282,0.348,0.379,0.706983798919928,1608,0.097,0.986301369863014,183,63.3879781420765,4528,970,0.32773851590106,0.379245283018868,106
"B Hamilton","CF",102,6269,1691,2159,242,95,40,739,1187,218,912,0,0.344,0.455,0.432,0.881211460507696,2711,0.088,5.44495412844037,912,100,7456,2430,0.448766094420601,0.432445366087095,156.725
"S Mertes","LF",827,4405,695,1227,188,108,40,721,422,10,396,0,0.279,0.346,0.398,0.739122891548133,1751,0.119,42.2,396,100,4827,1416,0.341620053863683,0.397502837684449,110.125
"A Everett","SS",880,2758,334,668,135,15,40,283,174,455,67,21,0.242,0.294,0.346,0.632716235641423,953,0.104,0.382417582417582,88,76.1363636363636,2932,617,0.287175989085948,0.345540246555475,68.95
"T Thompson","CF",299,790,114,176,39,5,42,117,91,272,15,3,0.223,0.304,0.444,0.747368496673803,351,0.221,0.334558823529412,18,83.3333333333333,881,231,0.303064699205448,0.444303797468354,18.8095238095238
"B Cowan","CF",493,1190,131,281,44,8,40,125,50,297,17,8,0.236,0.269,0.387,0.654330441854161,461,0.151,0.168350168350168,25,68,1240,256,0.266935483870968,0.387394957983193,29.75
"G Gross","RF",657,1461,203,349,78,8,40,186,199,349,22,10,0.239,0.33,0.385,0.715472980216554,563,0.146,0.570200573065903,32,68.75,1660,389,0.330120481927711,0.385352498288843,36.525
"J Royster","3B",1428,4208,552,1049,165,33,40,352,411,534,189,95,0.249,0.315,0.333,0.64878535261447,1400,0.084,0.769662921348315,284,66.5492957746479,4619,904,0.316085732842607,0.332699619771863,105.2
"T La Stella","3B",670,1723,207,459,98,5,40,204,172,217,5,3,0.266,0.336,0.399,0.731704687626815,687,0.133,0.792626728110599,8,62.5,1895,411,0.332981530343008,0.398723157283807,43.075
"E P?rez","C",564,1525,137,386,85,2,40,172,84,234,1,4,0.253,0.297,0.39,0.682270833121071,595,0.137,0.358974358974359,5,20,1609,309,0.292106898694842,0.390163934426229,38.125
"B Conigliaro","CF",347,1130,142,289,56,10,40,128,86,244,9,10,0.256,0.311,0.429,0.737591697717746,485,0.173,0.352459016393443,19,47.3684210526316,1216,270,0.308388157894737,0.429203539823009,28.25
"H Choi","1B",363,915,130,220,54,3,40,120,141,262,3,4,0.24,0.349,0.437,0.779014530551416,400,0.197,0.538167938931298,7,42.8571428571429,1056,250,0.341856060606061,0.437158469945355,22.875
"I Flagstead","CF",1219,4139,645,1202,262,50,40,450,467,288,71,58,0.29,0.37,0.407,0.769215012782575,1684,0.117,1.62152777777778,129,55.0387596899225,4606,1095,0.362353452019106,0.406861560763469,103.475
"J Smith","OF",1408,4532,783,1301,182,71,40,382,334,348,228,67,0.287,0.339,0.385,0.72104464974648,1745,0.098,0.959770114942529,295,77.2881355932203,4866,1165,0.336004932182491,0.385039717563989,113.3
"B Hamilton","CF",102,6269,1691,2159,242,95,40,739,1187,218,912,0,0.344,0.455,0.432,0.881211460507696,2711,0.088,5.44495412844037,912,100,7456,2430,0.448766094420601,0.432445366087095,156.725
"H Ferris","2B",1279,4800,473,1146,192,89,40,550,161,0,89,0,0.239,0.265,0.341,0.604288281932406,1636,0.102,Inf,89,100,4961,1023,0.263454948599073,0.340833333333333,120
"C Fernandez","SS",856,2778,270,666,91,19,40,259,213,338,68,28,0.24,0.292,0.329,0.623255295042796,915,0.089,0.630177514792899,96,70.8333333333333,2991,529,0.293881644934804,0.329373650107991,69.45
"E Coleman","RF",439,1337,193,381,67,23,40,246,117,152,1,3,0.285,0.345,0.459,0.8017405367701,614,0.174,0.769736842105263,4,25,1454,439,0.342503438789546,0.459237097980553,33.425
"M Chavis","1B",309,1015,117,241,38,7,40,137,59,345,7,4,0.237,0.283,0.407,0.686226160662685,413,0.17,0.171014492753623,11,63.6363636363636,1074,254,0.279329608938547,0.406896551724138,25.375
"M Wynne","CF",940,2693,300,664,107,28,40,244,191,398,80,58,0.247,0.297,0.352,0.648115677724084,947,0.105,0.479899497487437,138,57.9710144927536,2884,544,0.296463245492372,0.351652432231712,67.325
"B Gamel","LF",679,1950,259,493,107,15,40,198,225,545,21,15,0.253,0.333,0.385,0.71473032714412,750,0.132,0.412844036697248,36,58.3333333333333,2175,457,0.330114942528736,0.384615384615385,48.75
"C Lavagetto","3B",1043,3509,487,945,183,37,40,486,485,244,63,0,0.269,0.36,0.377,0.734782567125125,1322,0.108,1.98770491803279,63,100,3994,973,0.358037055583375,0.37674551154175,87.725
"B Wallace","1B",494,1284,143,305,68,3,40,138,119,432,2,2,0.238,0.316,0.389,0.69083883445132,499,0.151,0.275462962962963,4,50,1403,281,0.302209550962224,0.388629283489097,32.1
"A Dickerson","LF",339,902,136,230,49,8,40,132,81,204,7,2,0.255,0.325,0.46,0.776467125163252,415,0.205,0.397058823529412,9,77.7777777777778,983,268,0.316378433367243,0.460088691796009,22.55
"B Dent","SS",1392,4512,451,1114,169,23,40,423,328,348,17,29,0.247,0.297,0.321,0.619077501318797,1449,0.074,0.942528735632184,46,36.9565217391304,4840,874,0.297933884297521,0.321143617021277,112.8
"J Delsing","CF",822,2461,322,627,112,21,40,286,299,251,15,23,0.255,0.339,0.366,0.701618583231749,901,0.111,1.19123505976096,38,39.4736842105263,2760,608,0.335507246376812,0.366111336854937,61.525
"Y D?az","1B",475,1634,245,454,90,5,40,201,239,279,8,6,0.278,0.372,0.412,0.782479361094102,674,0.134,0.85663082437276,14,57.1428571428571,1873,446,0.369994660971703,0.412484700122399,40.85
"S Cox","1B",378,1239,146,324,72,2,39,158,129,240,8,4,0.262,0.34,0.417,0.748412344420373,517,0.155,0.5375,12,66.6666666666667,1368,304,0.331140350877193,0.41727199354318,31.7692307692308
"J Castillo","2B",592,1918,211,487,103,10,39,218,111,378,13,11,0.254,0.296,0.379,0.673767133601362,727,0.125,0.293650793650794,24,54.1666666666667,2029,429,0.294726466239527,0.379040667361835,49.1794871794872
"G Coan","LF",918,2877,384,731,98,44,39,278,232,384,83,38,0.254,0.316,0.359,0.669148054025488,1034,0.105,0.604166666666667,121,68.5950413223141,3109,662,0.309745899002895,0.359402155022593,73.7692307692308
"B Edwards","C",591,1675,191,429,67,20,39,241,190,179,9,3,0.256,0.335,0.39,0.721754231523348,653,0.134,1.06145251396648,12,75,1865,432,0.331903485254692,0.389850746268657,42.9487179487179
"K Farmer","3B",483,1349,147,343,61,4,39,184,76,287,11,7,0.254,0.311,0.392,0.686177415369409,529,0.138,0.264808362369338,18,61.1111111111111,1425,331,0.294035087719298,0.392142327650111,34.5897435897436
"E Lake","SS",836,2595,442,599,105,9,39,193,546,312,52,45,0.231,0.366,0.323,0.687847653539887,839,0.092,1.75,97,53.6082474226804,3141,635,0.36453358802929,0.323314065510597,66.5384615384615
"B Lange","CF",811,3195,689,1055,133,80,39,578,350,86,399,0,0.33,0.401,0.459,0.854861814674286,1465,0.129,4.06976744186047,399,100,3545,1267,0.396332863187588,0.458528951486698,81.9230769230769
"G Lachance","1B",581,4919,678,1377,197,86,39,690,219,124,192,0,0.28,0.318,0.379,0.689362218345923,1863,0.099,1.76612903225806,192,100,5138,1368,0.310626702997275,0.378735515348648,126.128205128205
"C Rupp","C",296,1027,100,240,57,2,39,124,87,323,2,1,0.234,0.298,0.407,0.700547515116976,418,0.173,0.269349845201238,3,66.6666666666667,1114,224,0.293536804308797,0.407010710808179,26.3333333333333
"T Ward","LF",297,988,143,256,49,4,39,124,103,274,11,4,0.259,0.335,0.435,0.76427858407211,430,0.176,0.375912408759124,15,73.3333333333333,1091,267,0.329055912007333,0.435222672064777,25.3333333333333
"C Mapes","RF",459,1193,199,289,55,13,38,172,168,213,8,9,0.242,0.338,0.406,0.741482429035896,484,0.164,0.788732394366197,17,47.0588235294118,1361,371,0.335782512858192,0.405699916177703,31.3947368421053
"A Mondesi","SS",358,1273,180,311,54,20,38,157,60,412,133,26,0.244,0.28,0.408,0.686017930248469,519,0.164,0.145631067961165,159,83.6477987421384,1333,337,0.278319579894974,0.407698350353496,33.5
"K Ginter","2B",325,971,120,236,52,4,38,140,105,230,9,2,0.243,0.329,0.422,0.739159606277206,410,0.179,0.456521739130435,11,81.8181818181818,1076,260,0.316914498141264,0.422245108135942,25.5526315789474
"M Johnson","1B",428,988,142,229,50,2,38,137,154,272,12,9,0.232,0.338,0.402,0.737198394747478,397,0.17,0.566176470588235,21,57.1428571428571,1142,279,0.335376532399299,0.401821862348178,26
"S Byrd","CF",746,1700,304,465,101,10,38,220,198,178,17,10,0.274,0.35,0.412,0.761079774375504,700,0.138,1.1123595505618,27,62.962962962963,1898,524,0.349315068493151,0.411764705882353,44.7368421052632
"F Rayford","3B",390,1044,112,255,43,1,38,117,55,225,4,5,0.244,0.283,0.397,0.678626337422735,414,0.153,0.244444444444444,9,44.4444444444444,1099,229,0.282074613284804,0.396551724137931,27.4736842105263
"B Mayne","C",1279,3614,359,951,178,8,38,403,370,580,18,27,0.263,0.332,0.348,0.679943765099135,1259,0.085,0.637931034482759,45,40,3984,762,0.331576305220884,0.348367459878251,95.1052631578947
"B Alyea","LF",371,866,100,214,33,2,38,148,100,210,5,7,0.247,0.326,0.421,0.746529819880558,365,0.174,0.476190476190476,12,41.6666666666667,966,248,0.325051759834369,0.421478060046189,22.7894736842105
"B Ayala","LF",425,865,114,217,42,1,38,145,71,136,2,4,0.251,0.305,0.434,0.741218319253001,375,0.183,0.522058823529412,6,33.3333333333333,936,259,0.307692307692308,0.433526011560694,22.7631578947368
"C Brown","3B",448,1523,164,410,61,6,38,184,120,252,21,17,0.269,0.333,0.392,0.7145701395802,597,0.123,0.476190476190476,38,55.2631578947368,1643,348,0.32258064516129,0.39198949441891,40.0789473684211
"M Hatcher","LF",1130,3377,348,946,172,20,38,375,164,246,11,15,0.28,0.313,0.377,0.690136450565929,1272,0.097,0.666666666666667,26,42.3076923076923,3541,723,0.313470770968653,0.376665679597276,88.8684210526316
"R Gutierrez","SS",1119,3632,471,967,141,25,38,357,364,586,50,30,0.266,0.338,0.35,0.683303347400264,1272,0.084,0.621160409556314,80,62.5,3996,828,0.333083083083083,0.350220264317181,95.5789473684211
"F Gustine","2B",1261,4582,553,1214,222,47,38,480,369,427,60,1,0.265,0.322,0.359,0.678528673095859,1644,0.094,0.864168618266979,61,98.3606557377049,4951,1033,0.319733387194506,0.358795285901353,120.578947368421
"B Myer","2B",1923,7038,1174,2131,353,130,38,850,965,428,156,109,0.303,0.389,0.406,0.79293620249042,2858,0.103,2.25467289719626,265,58.8679245283019,8003,2024,0.386854929401474,0.406081273088946,185.210526315789
"J Graham","1B",239,775,105,179,28,5,38,126,84,99,1,1,0.231,0.31,0.427,0.733266739269218,331,0.196,0.848484848484849,2,50,859,231,0.306169965075669,0.427096774193548,20.3947368421053
"M Salas","C",509,1292,142,319,49,10,38,143,89,163,3,3,0.247,0.3,0.389,0.683982979982648,502,0.142,0.54601226993865,6,50,1381,285,0.295438088341781,0.388544891640867,34
"J Titus","OF",1402,4960,738,1401,253,72,38,561,620,116,140,0,0.282,0.373,0.385,0.747670250896057,1912,0.103,5.3448275862069,140,100,5580,1299,0.362186379928315,0.385483870967742,130.526315789474
"C Shelton","1B",299,930,132,254,46,7,37,124,96,252,2,2,0.273,0.345,0.457,0.798119851600327,425,0.184,0.380952380952381,4,50,1026,256,0.341130604288499,0.456989247311828,25.1351351351351
"B Nieman","LF",332,1050,147,269,46,14,37,167,129,119,20,0,0.256,0.339,0.432,0.769955167817763,454,0.176,1.08403361344538,20,100,1179,314,0.337574215436811,0.432380952380952,28.3783783783784
"E Haase","C",236,731,91,169,29,2,37,111,52,236,2,0,0.231,0.284,0.428,0.710428339561789,313,0.197,0.220338983050847,2,100,783,202,0.282247765006386,0.428180574555404,19.7567567567568
"J Jay","CF",1201,3838,532,1087,185,25,37,341,285,716,55,33,0.283,0.348,0.373,0.706138950057994,1433,0.09,0.39804469273743,88,62.5,4123,873,0.33276740237691,0.373371547681084,103.72972972973
"L Harris","3B",1903,3924,460,1055,161,21,37,369,279,337,131,54,0.269,0.318,0.349,0.666271034014585,1369,0.08,0.827893175074184,185,70.8108108108108,4203,829,0.317392338805615,0.34887869520897,106.054054054054
"T Neel","DH",230,758,110,212,37,0,37,120,92,177,5,9,0.28,0.362,0.475,0.832581095762843,360,0.195,0.519774011299435,14,35.7142857142857,850,230,0.357647058823529,0.474934036939314,20.4864864864865
"P Whisenant","OF",475,988,140,221,46,8,37,134,86,196,17,5,0.224,0.284,0.399,0.684632724914995,394,0.175,0.438775510204082,22,77.2727272727273,1074,274,0.28584729981378,0.398785425101215,26.7027027027027
"B Spiers","SS",1252,3408,477,922,158,35,37,388,355,496,97,43,0.271,0.341,0.37,0.709368633182744,1261,0.099,0.715725806451613,140,69.2857142857143,3763,865,0.339356896093542,0.370011737089202,92.1081081081081
"L Aguayo","SS",568,1104,142,260,43,10,37,109,94,220,7,5,0.236,0.304,0.393,0.688608429508117,434,0.157,0.427272727272727,12,58.3333333333333,1198,251,0.295492487479132,0.393115942028986,29.8378378378378
"A Hechavarria","SS",922,3071,311,778,116,36,37,273,163,550,35,19,0.253,0.291,0.351,0.641671031516126,1077,0.098,0.296363636363636,54,64.8148148148148,3234,584,0.290970933828077,0.350700097688049,83
"D Cramer","CF",2238,9140,1357,2705,396,109,37,842,572,345,62,73,0.296,0.34,0.375,0.71269115065303,3430,0.079,1.65797101449275,135,45.9259259259259,9712,2199,0.3374176276771,0.37527352297593,247.027027027027
"R Murray","RF",1270,4334,555,1170,168,96,37,579,299,194,321,8,0.27,0.323,0.379,0.695707227030738,1641,0.109,1.54123711340206,329,97.5683890577508,4633,1134,0.317073170731707,0.378634056299031,117.135135135135
"G Stephens","OF",965,1913,283,460,78,15,37,207,233,322,27,20,0.24,0.325,0.355,0.677866259647899,679,0.115,0.72360248447205,47,57.4468085106383,2146,490,0.322926374650513,0.354939884997386,51.7027027027027
"C Biggio","2B",337,1083,177,246,61,4,37,127,189,347,25,1,0.227,0.347,0.393,0.735332932629488,426,0.166,0.544668587896254,26,96.1538461538462,1272,304,0.341981132075472,0.393351800554017,29.2702702702703
"L Gabrielson","LF",708,1764,178,446,64,12,37,176,145,315,20,12,0.253,0.309,0.366,0.675232429273438,645,0.113,0.46031746031746,32,62.5,1909,354,0.309586170770037,0.365646258503401,47.6756756756757
"J Camargo","3B",416,1225,149,312,71,4,37,159,99,280,2,1,0.255,0.313,0.41,0.720218879092422,502,0.155,0.353571428571429,3,66.6666666666667,1324,308,0.310422960725076,0.409795918367347,33.1081081081081
"O Moreno","CF",1382,4992,699,1257,171,87,37,386,387,885,487,182,0.252,0.306,0.343,0.648782055750997,1713,0.091,0.43728813559322,669,72.7952167414051,5379,1085,0.305633017289459,0.343149038461538,134.918918918919
"B Lemon","P",615,1183,148,274,54,9,37,147,93,241,2,1,0.232,0.288,0.386,0.673923556549551,457,0.154,0.385892116182573,3,66.6666666666667,1276,295,0.287617554858934,0.386306001690617,31.972972972973
"C Owings","2B",712,2280,262,546,124,27,37,220,143,598,79,16,0.239,0.287,0.366,0.650586303770156,835,0.127,0.239130434782609,95,83.1578947368421,2423,482,0.284358233594717,0.366228070175439,61.6216216216216
"A Altherr","RF",359,1016,142,222,54,10,37,150,110,332,21,10,0.219,0.307,0.401,0.695439574271689,407,0.182,0.331325301204819,31,67.741935483871,1126,292,0.294849023090586,0.400590551181102,27.4594594594595
"E Smith","LF",20,4684,912,1454,196,136,37,663,636,139,232,0,0.31,0.398,0.434,0.826887885811882,2033,0.124,4.57553956834532,232,100,5320,1575,0.392857142857143,0.43403074295474,126.594594594595
"P Garcia","2B",558,1797,196,395,89,15,37,184,102,329,35,26,0.22,0.267,0.348,0.609518585038607,625,0.128,0.310030395136778,61,57.3770491803279,1899,380,0.261716692996314,0.347801892042293,48.5675675675676
"J Naylor","1B",329,1045,118,264,59,1,37,140,82,204,9,2,0.253,0.311,0.417,0.724234640808685,436,0.164,0.401960784313726,11,81.8181818181818,1127,258,0.307009760425909,0.417224880382775,28.2432432432432
"B Clark","RF",785,2015,264,559,97,7,36,210,208,252,48,33,0.277,0.358,0.386,0.731133458128365,778,0.109,0.825396825396825,81,59.2592592592593,2223,474,0.345029239766082,0.386104218362283,55.9722222222222
"J Castro","SS",1103,2627,253,601,123,13,36,234,149,472,5,9,0.229,0.268,0.327,0.596781209102109,858,0.098,0.315677966101695,14,35.7142857142857,2776,487,0.270172910662824,0.326608298439284,72.9722222222222
"D Jimenez","2B",641,2159,290,568,105,17,36,228,291,391,36,22,0.263,0.351,0.377,0.728101823406528,815,0.114,0.744245524296675,58,62.0689655172414,2450,518,0.350612244897959,0.377489578508569,59.9722222222222
"E Koy","LF",558,1846,238,515,108,29,36,260,137,284,40,0,0.279,0.332,0.427,0.756205372972542,789,0.148,0.482394366197183,40,100,1983,498,0.328794755421079,0.427410617551463,51.2777777777778
"J Vizcaino","SS",1820,5379,633,1453,204,47,36,480,378,729,74,62,0.27,0.318,0.346,0.663650866216748,1859,0.076,0.518518518518518,136,54.4117647058823,5757,1113,0.318047594233108,0.34560327198364,149.416666666667
"P Kelly","2B",681,1988,253,495,109,11,36,217,145,425,61,29,0.249,0.307,0.369,0.669262174075866,734,0.12,0.341176470588235,90,67.7777777777778,2133,470,0.300046882325363,0.369215291750503,55.2222222222222
"B Wills","2B",831,3030,472,807,128,24,36,302,310,441,196,65,0.266,0.335,0.36,0.694497144325211,1091,0.094,0.702947845804989,261,75.095785440613,3340,774,0.334431137724551,0.36006600660066,84.1666666666667
"G Strickland","SS",971,2824,305,633,84,27,36,284,361,453,12,10,0.224,0.313,0.311,0.623348535317374,879,0.087,0.796909492273731,22,54.5454545454545,3185,589,0.312087912087912,0.311260623229462,78.4444444444444
"C Pennington","SS",971,2799,324,678,120,21,36,242,266,619,84,28,0.242,0.309,0.339,0.646685864853854,948,0.097,0.429725363489499,112,75,3065,566,0.307993474714519,0.338692390139335,77.75
"D McCarty","1B",632,1493,182,362,68,8,36,175,126,367,9,9,0.242,0.305,0.371,0.672485599877874,554,0.129,0.343324250681199,18,50,1619,357,0.30142063001853,0.371064969859344,41.4722222222222
"J Berardino","2B",912,3028,334,755,167,23,36,387,284,268,27,29,0.249,0.316,0.355,0.669057795518797,1076,0.106,1.05970149253731,56,48.2142857142857,3312,721,0.313707729468599,0.355350066050198,84.1111111111111
"F Valentine","OF",533,1458,180,360,56,10,36,138,156,228,47,16,0.247,0.33,0.373,0.692816456825819,544,0.126,0.684210526315789,63,74.6031746031746,1614,318,0.319702602230483,0.373113854595336,40.5
"M Marion","SS",1572,5506,602,1448,272,37,36,624,470,537,35,2,0.263,0.323,0.345,0.666391805264404,1902,0.082,0.875232774674115,37,94.5945945945946,5976,1226,0.32095046854083,0.345441336723574,152.944444444444
"J Peterson","3B",743,2023,239,466,90,14,36,207,260,512,62,21,0.23,0.321,0.342,0.660068866380903,692,0.112,0.5078125,83,74.6987951807229,2283,446,0.318002628120894,0.34206623826001,56.1944444444444
"V Davalillo","CF",1458,4017,509,1122,160,37,36,329,212,422,125,58,0.279,0.315,0.364,0.679892085498773,1464,0.085,0.502369668246445,183,68.3060109289617,4229,838,0.315441002601088,0.364451082897685,111.583333333333
"T Harper","LF",540,1467,147,371,55,5,36,180,144,248,37,28,0.253,0.321,0.371,0.690502031661164,544,0.118,0.580645161290323,65,56.9230769230769,1611,327,0.31967721911856,0.370824812542604,40.75
"F Menechino","2B",450,1257,207,302,58,7,36,149,200,279,3,10,0.24,0.358,0.383,0.727996247779763,482,0.143,0.716845878136201,13,23.0769230769231,1457,356,0.344543582704187,0.383452665075577,34.9166666666667
"T Uhlaender","CF",898,2932,343,772,114,21,36,285,202,277,52,35,0.263,0.311,0.353,0.664127367751136,1036,0.09,0.729241877256318,87,59.7701149425287,3134,628,0.310784939374601,0.353342428376535,81.4444444444444
"C Stahl","CF",782,5069,858,1546,219,118,36,622,470,0,189,0,0.305,0.369,0.416,0.780023008711947,2109,0.111,Inf,189,100,5539,1480,0.363964614551363,0.416058394160584,140.805555555556
"L Polonia","LF",1379,4840,728,1417,189,70,36,405,369,543,321,145,0.293,0.342,0.383,0.725925964121221,1854,0.09,0.679558011049724,466,68.8841201716738,5209,1133,0.342868112881551,0.383057851239669,134.444444444444
"L Stahl","OF",730,1721,167,400,58,19,36,163,142,357,22,16,0.232,0.292,0.351,0.641887354684936,604,0.119,0.397759103641457,38,57.8947368421053,1863,330,0.290928609769189,0.350958744915747,47.8055555555556
"J Girardi","C",1277,4127,454,1100,186,26,36,422,279,607,44,31,0.267,0.315,0.35,0.663357872346463,1446,0.083,0.459637561779242,75,58.6666666666667,4406,876,0.312982296867907,0.350375575478556,114.638888888889
"L Sojo","2B",848,2571,300,671,103,12,36,261,124,198,28,20,0.261,0.297,0.352,0.647382788906376,906,0.091,0.626262626262626,48,58.3333333333333,2695,561,0.294990723562152,0.352392065344224,71.4166666666667
"D Garcia","2B",1032,3914,490,1108,183,27,36,323,130,322,203,90,0.283,0.309,0.371,0.677364018787714,1453,0.088,0.403726708074534,293,69.2832764505119,4044,813,0.306132542037587,0.371231476750128,108.722222222222
"R Ruffing","P",882,1937,209,521,98,13,36,273,97,266,1,1,0.269,0.306,0.389,0.692580290964801,753,0.12,0.364661654135338,2,50,2034,482,0.303834808259587,0.388745482705214,53.8055555555556
"B Fothergill","LF",1105,3269,452,1064,225,52,36,582,202,177,42,52,0.325,0.368,0.459,0.823898210395816,1501,0.134,1.14124293785311,94,44.6808510638298,3471,1034,0.364736387208297,0.459161823187519,90.8055555555556
"S Leslie","1B",823,2460,311,749,123,28,36,389,216,118,14,0,0.304,0.366,0.421,0.781751066389588,1036,0.117,1.83050847457627,14,100,2676,700,0.360612855007474,0.421138211382114,68.3333333333333
"M Vail","RF",665,1604,146,447,71,11,34,219,81,317,3,17,0.279,0.313,0.4,0.713602492285606,642,0.121,0.255520504731861,20,15,1685,365,0.313353115727003,0.400249376558603,47.1764705882353
"G Adams","DH",661,1617,152,452,79,5,34,225,111,183,6,10,0.28,0.324,0.398,0.723460154263726,643,0.118,0.60655737704918,16,37.5,1728,377,0.325810185185185,0.39764996907854,47.5588235294118
"M Cubbage","3B",703,1951,218,503,74,20,34,251,215,233,6,15,0.258,0.33,0.369,0.700015570772949,719,0.111,0.92274678111588,21,28.5714285714286,2166,469,0.331486611265005,0.368528959507945,57.3823529411765
"L Rivas","2B",648,2101,286,541,92,29,34,201,126,316,81,25,0.257,0.303,0.377,0.676945376578861,793,0.12,0.39873417721519,106,76.4150943396226,2227,487,0.299506061966771,0.377439314612089,61.7941176470588
"T Helms","2B",1435,4997,414,1342,223,21,34,477,231,301,33,40,0.269,0.3,0.342,0.642885080704123,1709,0.073,0.767441860465116,73,45.2054794520548,5228,891,0.300879877582249,0.342005203121873,146.970588235294
"W Newson","RF",489,992,156,248,40,4,34,120,196,292,14,3,0.25,0.374,0.401,0.774947051156729,398,0.151,0.671232876712329,17,82.3529411764706,1188,276,0.373737373737374,0.401209677419355,29.1764705882353
"T Savage","LF",642,1375,202,321,51,11,34,163,200,272,49,24,0.233,0.334,0.361,0.691520923520924,496,0.128,0.735294117647059,73,67.1232876712329,1575,365,0.330793650793651,0.360727272727273,40.4411764705882
"R Mack","2B",791,2707,273,629,113,24,34,278,261,365,35,17,0.232,0.301,0.33,0.629381298560087,892,0.098,0.715068493150685,52,67.3076923076923,2968,551,0.299865229110512,0.329516069449575,79.6176470588235
"T Cruz","SS",544,1526,133,336,58,6,34,154,59,317,9,24,0.22,0.251,0.333,0.582107817803705,508,0.113,0.186119873817035,33,27.2727272727273,1585,287,0.249211356466877,0.332896461336828,44.8823529411765
"J Branson","3B",694,1555,173,383,72,11,34,156,122,312,9,5,0.246,0.3,0.372,0.673480242432609,579,0.126,0.391025641025641,14,64.2857142857143,1677,329,0.30113297555158,0.372347266881029,45.7352941176471
"J Russell","C",448,1087,113,245,50,3,34,129,84,355,3,3,0.225,0.282,0.371,0.651701617673978,403,0.146,0.236619718309859,6,50,1171,242,0.280956447480786,0.370745170193192,31.9705882352941
"B Bradley","3B",1231,5430,754,1471,275,84,34,552,290,18,181,0,0.271,0.317,0.371,0.679137851099177,2016,0.1,16.1111111111111,181,100,5720,1306,0.307867132867133,0.371270718232044,159.705882352941
"T Corcoran","SS",764,8804,1184,2252,289,155,34,1135,382,205,387,0,0.256,0.289,0.335,0.622156412485151,2953,0.079,1.86341463414634,387,100,9186,2319,0.286740692357936,0.335415720127215,258.941176470588
"J Fields","3B",217,713,95,167,25,3,34,107,69,235,3,4,0.234,0.303,0.421,0.72254764458378,300,0.187,0.293617021276596,7,42.8571428571429,782,202,0.301790281329923,0.420757363253857,20.9705882352941
"C Ross","LF",413,1309,156,316,53,21,34,170,124,281,6,0,0.241,0.309,0.392,0.698950366164356,513,0.151,0.441281138790036,6,100,1433,326,0.307048150732729,0.391902215431627,38.5
"S Fletcher","SS",1612,5258,688,1376,243,38,34,510,514,541,99,58,0.262,0.332,0.342,0.669207757073866,1797,0.08,0.950092421441775,157,63.0573248407643,5772,1198,0.327442827442827,0.341764929631038,154.647058823529
"F Fennelly","SS",786,3042,609,781,102,82,34,408,378,78,175,0,0.257,0.345,0.378,0.716600920447074,1149,0.121,4.84615384615385,175,100,3420,1017,0.338888888888889,0.377712031558185,89.4705882352941
"H Landrith","C",772,1929,179,450,69,5,34,203,253,188,5,12,0.233,0.32,0.327,0.649293978396219,631,0.094,1.34574468085106,17,29.4117647058824,2182,382,0.32218148487626,0.327112493519959,56.7352941176471
"K Wood","RF",342,995,110,223,52,7,34,143,102,141,1,7,0.224,0.298,0.393,0.689227358304742,391,0.169,0.723404255319149,8,12.5,1097,253,0.296262534184139,0.392964824120603,29.2647058823529
"B Wallace","SS",1741,8618,1057,2309,391,143,34,1121,774,79,201,2,0.268,0.332,0.358,0.686577887769468,3088,0.09,9.79746835443038,203,99.0147783251232,9392,2178,0.328258091993186,0.358319795776282,253.470588235294
"A Cianfrocco","1B",500,1276,136,308,59,7,34,185,80,360,16,3,0.241,0.292,0.379,0.664662338983364,483,0.138,0.222222222222222,19,84.2105263157895,1356,321,0.286135693215339,0.378526645768025,37.5294117647059
"T Tarasco","LF",457,1006,151,241,46,5,34,118,106,171,39,10,0.24,0.313,0.397,0.70867063804225,399,0.157,0.619883040935672,49,79.5918367346939,1112,269,0.31205035971223,0.39662027833002,29.5882352941176
"E Ott","C",567,1792,196,465,76,10,33,195,138,254,14,16,0.259,0.311,0.368,0.680738804589193,660,0.109,0.543307086614173,30,46.6666666666667,1930,391,0.312435233160622,0.368303571428571,54.3030303030303
"I Murrell","LF",564,1306,126,308,41,15,33,123,44,342,20,13,0.236,0.265,0.366,0.626743803527877,478,0.13,0.128654970760234,33,60.6060606060606,1350,249,0.260740740740741,0.366003062787136,39.5757575757576
"W Keeler","RF",1160,8591,1719,2932,241,145,33,810,524,36,495,0,0.341,0.388,0.415,0.793775189729292,3562,0.074,14.5555555555556,495,100,9115,2529,0.379155238617663,0.414619951111628,260.333333333333
"L Bierbauer","2B",1383,5706,819,1521,208,95,33,835,268,129,206,0,0.267,0.301,0.354,0.653127156573215,2018,0.087,2.07751937984496,206,100,5974,1654,0.299464345497154,0.35366281107606,172.909090909091
"D Johnston","CF",746,2992,453,751,109,68,33,386,133,283,151,0,0.251,0.285,0.366,0.648855935828877,1095,0.115,0.469964664310954,151,100,3125,839,0.28288,0.365975935828877,90.6666666666667
"D Murphy","3B",335,838,102,178,46,4,33,119,64,264,7,4,0.212,0.279,0.395,0.663280749752605,331,0.183,0.242424242424242,11,63.6363636363636,902,221,0.268292682926829,0.394988066825776,25.3939393939394
"A Almora","RF",600,1491,189,386,76,5,33,163,86,290,7,6,0.259,0.3,0.383,0.682266926437084,571,0.124,0.296551724137931,13,53.8461538461538,1577,352,0.299302473050095,0.382964453386989,45.1818181818182
"L Milledge","CF",433,1500,166,404,73,8,33,167,104,287,40,20,0.269,0.328,0.395,0.711374896093101,592,0.126,0.362369337979094,60,66.6666666666667,1604,333,0.316708229426434,0.394666666666667,45.4545454545455
"W Williams","RF",842,2373,284,640,106,11,33,173,126,211,34,19,0.27,0.31,0.365,0.671882912457018,867,0.095,0.597156398104265,53,64.1509433962264,2499,457,0.306522609043617,0.365360303413401,71.9090909090909
"K Hunt","CF",310,782,107,177,42,4,33,111,85,222,9,4,0.226,0.303,0.417,0.719071260217642,326,0.191,0.382882882882883,13,69.2307692307692,867,218,0.302191464821223,0.416879795396419,23.6969696969697
"K Blanks","LF",278,827,110,199,42,2,33,111,83,275,6,2,0.241,0.322,0.416,0.72585141581514,344,0.175,0.301818181818182,8,75,910,221,0.30989010989011,0.41596130592503,25.0606060606061
"W Aybar","3B",405,1219,137,315,68,2,33,157,142,206,7,5,0.258,0.341,0.399,0.734469961586658,486,0.141,0.689320388349515,12,58.3333333333333,1361,294,0.335782512858192,0.398687448728466,36.9393939393939
"B Stinson","C",652,1634,166,408,61,7,33,180,201,254,8,10,0.25,0.337,0.356,0.688061259542621,582,0.106,0.791338582677165,18,44.4444444444444,1835,346,0.331880108991826,0.356181150550796,49.5151515151515
"B Harris","SS",529,1694,208,434,99,7,33,167,132,343,5,5,0.256,0.314,0.381,0.691313068092915,646,0.125,0.384839650145773,10,50,1826,375,0.309967141292443,0.381345926800472,51.3333333333333
"T Whitfield","OF",730,1913,233,537,93,12,33,179,138,288,18,25,0.281,0.33,0.394,0.72273033464736,753,0.113,0.479166666666667,43,41.8604651162791,2051,412,0.329107752315943,0.393622582331417,57.969696969697
"F Beck","1B",358,2130,191,536,78,27,33,251,122,193,31,0,0.252,0.301,0.36,0.65227862140278,767,0.108,0.632124352331606,31,100,2252,442,0.292184724689165,0.360093896713615,64.5454545454545
"T Austin","1B",209,521,75,114,20,1,33,91,54,215,4,2,0.219,0.292,0.451,0.743229575231578,235,0.232,0.251162790697674,6,66.6666666666667,575,166,0.292173913043478,0.4510556621881,15.7878787878788
"J DaVanon","RF",528,1288,205,333,57,13,33,150,185,268,59,23,0.259,0.349,0.4,0.751507992730431,515,0.141,0.690298507462687,82,71.9512195121951,1473,355,0.351663272233537,0.399844720496894,39.030303030303
"M Mahtook","CF",291,884,112,208,33,9,33,97,59,255,14,5,0.235,0.292,0.405,0.688116293911316,358,0.17,0.231372549019608,19,73.6842105263158,943,209,0.283138918345705,0.404977375565611,26.7878787878788
"A Luplow","RF",481,1243,147,292,34,6,33,125,127,213,8,11,0.235,0.311,0.352,0.657408201255498,437,0.117,0.596244131455399,19,42.1052631578947,1370,272,0.305839416058394,0.351568785197104,37.6666666666667
"C Woodward","SS",659,1706,211,408,87,14,33,191,137,400,9,6,0.239,0.296,0.365,0.660309055715393,622,0.126,0.3425,15,60,1843,402,0.295713510580575,0.364595545134818,51.6969696969697
"R Langerhans","LF",597,1250,177,283,58,12,33,125,192,388,11,8,0.226,0.333,0.371,0.700603606102635,464,0.145,0.494845360824742,19,57.8947368421053,1442,302,0.329403606102635,0.3712,37.8787878787879
"C Gillaspie","3B",513,1424,147,357,73,14,33,158,107,245,1,8,0.251,0.304,0.391,0.694221574354722,557,0.14,0.436734693877551,9,11.1111111111111,1531,305,0.303069888961463,0.391151685393258,43.1515151515151
"L Webster","C",587,1450,157,368,73,2,33,176,140,209,1,3,0.254,0.324,0.375,0.694669269139015,544,0.121,0.669856459330144,4,25,1590,333,0.319496855345912,0.375172413793103,43.9393939393939
"C Garcia","2B",610,2178,274,580,102,17,33,197,115,340,73,33,0.266,0.307,0.374,0.677292890847979,815,0.108,0.338235294117647,106,68.8679245283019,2293,471,0.303096380287833,0.374196510560147,66
"S Cooper","3B",592,1801,197,478,94,12,33,211,193,299,7,10,0.265,0.337,0.386,0.722406252627956,695,0.121,0.645484949832776,17,41.1764705882353,1994,408,0.336509528585757,0.385896724042199,54.5757575757576
"B Warren","C",377,989,97,217,26,7,33,104,129,177,1,0,0.219,0.313,0.36,0.669440771564128,356,0.141,0.728813559322034,1,100,1118,201,0.309481216457961,0.359959555106168,29.969696969697
"N Aoki","RF",759,2716,377,774,135,22,33,219,234,258,98,44,0.285,0.35,0.387,0.729029230423604,1052,0.102,0.906976744186046,142,69.0140845070423,2950,596,0.341694915254237,0.387334315169367,82.3030303030303
"P Collins","C",544,1204,147,306,46,6,33,168,235,202,4,5,0.254,0.378,0.385,0.760507019686521,463,0.131,1.16336633663366,9,44.4444444444444,1439,315,0.37595552466991,0.384551495016611,36.4848484848485
"A Slater","CF",461,1120,162,286,47,9,33,133,134,352,43,4,0.255,0.345,0.402,0.736713943950786,450,0.147,0.380681818181818,47,91.4893617021277,1254,295,0.334928229665072,0.401785714285714,33.9393939393939
"H Lee","LF",752,2750,316,755,144,40,33,323,203,225,15,0,0.275,0.326,0.392,0.716415848289875,1078,0.117,0.902222222222222,15,100,2953,639,0.324415848289875,0.392,83.3333333333333
"P Severino","C",370,1113,107,261,51,1,33,134,107,290,5,1,0.235,0.306,0.371,0.672708526652232,413,0.136,0.368965517241379,6,83.3333333333333,1220,241,0.301639344262295,0.371069182389937,33.7272727272727
"J Essian","C",710,1855,194,453,85,3,33,207,231,171,9,13,0.244,0.327,0.347,0.674531015394634,643,0.103,1.35087719298246,22,40.9090909090909,2086,401,0.327900287631831,0.346630727762803,56.2121212121212
"C Worthington","3B",393,1234,126,284,50,0,33,144,162,264,3,6,0.23,0.322,0.351,0.670375650736301,433,0.121,0.613636363636364,9,33.3333333333333,1396,270,0.319484240687679,0.350891410048622,37.3939393939394
"R Paulino","C",573,1867,181,508,93,1,33,216,145,328,4,2,0.272,0.324,0.376,0.700556968845736,702,0.104,0.442073170731707,6,66.6666666666667,2012,397,0.32455268389662,0.376004284949116,56.5757575757576
"S Taylor","C",473,1263,127,309,47,9,33,147,122,181,3,2,0.245,0.313,0.375,0.685696482216715,473,0.13,0.674033149171271,5,60,1385,274,0.311191335740072,0.374505146476643,38.2727272727273
"G Miller","C",1317,5167,839,1380,192,57,33,567,467,129,260,0,0.267,0.333,0.345,0.673292609037762,1785,0.078,3.62015503875969,260,100,5634,1406,0.327831025914093,0.345461583123669,156.575757575758
"A Cintron","SS",680,2056,244,565,104,21,33,222,112,230,18,14,0.275,0.313,0.394,0.706238244289058,810,0.119,0.48695652173913,32,56.25,2168,466,0.312269372693727,0.393968871595331,62.3030303030303
"J Cave","LF",337,929,130,217,43,10,33,118,66,331,6,4,0.234,0.296,0.408,0.69238766491229,379,0.174,0.199395770392749,10,60,995,248,0.284422110552764,0.407965554359526,28.1515151515152
"D Richardson","2B",1131,4451,676,1129,149,52,32,558,283,289,225,0,0.254,0.301,0.332,0.630328060787145,1478,0.078,0.97923875432526,225,100,4734,1234,0.298267849598648,0.332060211188497,139.09375
"D Bancroft","SS",1913,7182,1048,2004,320,77,32,591,827,487,145,75,0.279,0.355,0.358,0.711873327969693,2574,0.079,1.69815195071869,220,65.9090909090909,8009,1639,0.353477337994756,0.358395989974937,224.4375
"J Kennedy","3B",856,2110,237,475,77,17,32,185,142,461,14,10,0.225,0.281,0.323,0.597201434427955,682,0.098,0.308026030368764,24,58.3333333333333,2252,422,0.273978685612789,0.323222748815166,65.9375
"R Katt","C",417,1071,92,248,29,4,32,120,74,164,2,2,0.232,0.282,0.356,0.636965004342348,381,0.124,0.451219512195122,4,50,1145,212,0.281222707423581,0.355742296918768,33.46875
"Y S?nchez","3B",675,2276,253,552,113,24,32,217,165,532,30,25,0.243,0.299,0.355,0.649180231674909,809,0.112,0.31015037593985,55,54.5454545454545,2441,470,0.293732077017616,0.355448154657294,71.125
"B Wilson","OF",224,654,87,145,23,1,32,77,72,136,2,4,0.222,0.308,0.407,0.705625900371522,266,0.185,0.529411764705882,6,33.3333333333333,726,164,0.298898071625344,0.406727828746177,20.4375
"T Jordan","1B",543,1813,220,474,74,24,32,232,254,2,48,0,0.261,0.355,0.382,0.733889068120874,692,0.121,127,48,100,2067,452,0.352201257861635,0.381687810259239,56.65625
"Q Veras","2B",767,2780,469,750,129,15,32,239,427,462,183,83,0.27,0.372,0.362,0.728520457721755,1005,0.092,0.924242424242424,266,68.796992481203,3207,708,0.367009666354849,0.361510791366906,86.875
"J Wilson","C",1525,4778,580,1358,252,32,32,621,356,280,86,9,0.284,0.336,0.37,0.704300632541402,1770,0.086,1.27142857142857,95,90.5263157894737,5134,1201,0.333852746396572,0.37044788614483,149.3125
"D Siebert","1B",1035,3917,439,1104,204,40,32,482,276,185,30,32,0.282,0.332,0.379,0.707981335341291,1484,0.097,1.49189189189189,62,48.3870967741936,4193,921,0.329119961841164,0.378861373500128,122.40625
"D James","LF",917,2708,362,781,142,21,32,266,318,307,43,38,0.288,0.364,0.392,0.754987791674518,1061,0.104,1.03583061889251,81,53.0864197530864,3026,628,0.363185723727693,0.391802067946824,84.625
"D Jackson","2B",827,2209,332,536,121,17,32,198,245,517,133,39,0.243,0.323,0.356,0.67452571406224,787,0.113,0.473887814313346,172,77.3255813953488,2454,530,0.318255908720456,0.356269805341784,69.03125
"C Hurdle","RF",515,1391,162,360,81,12,32,193,176,261,1,6,0.259,0.341,0.403,0.745361855340444,561,0.144,0.674329501915709,7,14.2857142857143,1567,355,0.342054881940013,0.403306973400431,43.46875
"B O'Brien","1B",356,1424,164,364,59,22,32,206,59,88,26,0,0.256,0.289,0.395,0.680597805086865,563,0.139,0.670454545454545,26,100,1483,370,0.285232636547539,0.395365168539326,44.5
"A Barnes","C",488,1161,175,260,52,3,32,138,164,300,18,5,0.224,0.332,0.357,0.676589147286822,414,0.133,0.546666666666667,23,78.2608695652174,1325,313,0.32,0.356589147286822,36.28125
"H Lobert","3B",1321,4563,640,1252,159,82,32,482,395,156,316,15,0.274,0.337,0.366,0.698396842484099,1671,0.092,2.53205128205128,331,95.4682779456193,4958,1122,0.332190399354578,0.36620644312952,142.59375
"P Young","2B",731,2466,274,645,128,34,32,347,152,312,18,0,0.262,0.308,0.38,0.684398422054068,937,0.118,0.487179487179487,18,100,2618,621,0.304430863254393,0.379967558799676,77.0625
"M Smith","LF",414,959,125,233,51,3,32,130,97,211,15,5,0.243,0.316,0.403,0.715002606882169,386,0.16,0.459715639810427,20,75,1056,255,0.3125,0.402502606882169,29.96875
"J Lis","1B",356,780,96,182,31,1,32,92,110,209,1,3,0.233,0.332,0.399,0.726807836358398,311,0.166,0.526315789473684,4,25,890,188,0.328089887640449,0.398717948717949,24.375
"T Foley","SS",1108,2708,248,661,134,20,32,263,232,387,32,29,0.244,0.303,0.344,0.647537656125966,931,0.1,0.599483204134367,61,52.4590163934426,2940,511,0.303741496598639,0.343796159527326,84.625
"A Fletcher","SS",1537,5541,684,1534,238,77,32,675,203,348,159,28,0.277,0.319,0.365,0.667318587093729,2022,0.088,0.583333333333333,187,85.0267379679144,5744,1359,0.302402506963788,0.36491608012994,173.15625
"M Morandini","2B",1298,4558,597,1222,209,54,32,351,437,714,123,45,0.268,0.338,0.359,0.690842092641127,1635,0.091,0.612044817927171,168,73.2142857142857,4995,948,0.332132132132132,0.358709960508995,142.4375
"M Lemke","2B",1069,3230,349,795,125,15,32,270,348,341,11,19,0.246,0.317,0.324,0.643291217225321,1046,0.078,1.02052785923754,30,36.6666666666667,3578,619,0.319452207937395,0.323839009287926,100.9375
"D Collins","LF",1701,4907,667,1335,187,52,32,373,467,661,395,139,0.272,0.338,0.351,0.686245445524948,1722,0.079,0.706505295007564,534,73.9700374531835,5374,1040,0.335318198734648,0.3509272467903,153.34375
"S Evans","RF",682,3359,478,963,175,67,32,466,359,299,86,0,0.287,0.374,0.407,0.762831576100177,1368,0.12,1.20066889632107,86,100,3718,944,0.355567509413663,0.407264066686514,104.96875
"W English","SS",1262,4746,801,1356,236,52,32,422,571,536,57,0,0.286,0.366,0.378,0.74000353960109,1792,0.092,1.06529850746269,57,100,5317,1223,0.362422418657137,0.377581120943953,148.3125
"J Mokan","LF",582,1936,282,563,98,17,32,273,206,150,26,22,0.291,0.364,0.409,0.767584650940266,791,0.118,1.37333333333333,48,54.1666666666667,2142,555,0.359010270774977,0.408574380165289,60.5
"G Larkin","1B",758,2321,275,618,131,12,32,266,268,278,23,17,0.266,0.348,0.374,0.716624655167048,869,0.108,0.964028776978417,40,57.5,2589,541,0.34221707222866,0.374407582938389,72.53125
"N Larker","1B",667,1953,227,538,97,15,32,271,211,165,3,5,0.275,0.347,0.39,0.735775237489506,761,0.115,1.27878787878788,8,37.5,2164,498,0.346118299445471,0.389656938044035,61.03125
"J Early","C",747,2208,216,532,98,23,32,264,281,259,7,8,0.241,0.33,0.35,0.676274884855684,772,0.109,1.08494208494208,15,46.6666666666667,2489,480,0.326637203696264,0.34963768115942,69
"A Clark","RF",358,1021,131,267,48,4,32,149,72,70,2,5,0.262,0.312,0.41,0.720537513676651,419,0.148,1.02857142857143,7,28.5714285714286,1093,280,0.310155535224154,0.410381978452498,31.90625
"G Bird","1B",186,611,75,129,32,1,32,98,74,189,0,0,0.211,0.301,0.424,0.720245618645991,259,0.213,0.391534391534392,0,0,685,173,0.296350364963504,0.423895253682488,19.09375
"D Miller","1B",1591,5805,711,1526,232,108,32,715,391,454,177,30,0.263,0.314,0.357,0.665982304162225,2070,0.094,0.861233480176211,207,85.5072463768116,6196,1426,0.309393156875403,0.356589147286822,181.40625
"B Buchanan","RF",346,767,105,198,37,3,32,103,73,210,9,7,0.258,0.328,0.439,0.761993232755945,337,0.181,0.347619047619048,16,56.25,840,208,0.322619047619048,0.439374185136897,23.96875
"A Torres","CF",650,1910,277,462,113,29,32,174,205,476,77,29,0.242,0.317,0.382,0.697041822930204,729,0.14,0.430672268907563,106,72.6415094339623,2115,451,0.315366430260047,0.381675392670157,59.6875
"A Vaughn","1B",265,941,117,240,53,1,32,128,73,200,1,1,0.255,0.317,0.416,0.724193910125407,391,0.161,0.365,2,50,1014,245,0.308678500986193,0.415515409139214,29.40625
"J India","2B",256,929,150,244,51,4,32,111,104,237,16,7,0.263,0.358,0.429,0.766376945096008,399,0.166,0.438818565400844,23,69.5652173913043,1033,261,0.336882865440465,0.429494079655544,29.03125
"B Metheny","RF",376,1390,187,344,52,5,31,156,149,122,12,10,0.247,0.323,0.359,0.679330687496786,499,0.112,1.22131147540984,22,54.5454545454545,1539,343,0.32033788174139,0.358992805755396,44.8387096774194
"M Owen","3B",1011,3782,473,1040,167,44,31,497,338,283,30,30,0.275,0.339,0.367,0.701467605879665,1388,0.092,1.19434628975265,60,50,4120,970,0.334466019417476,0.367001586462189,122
"M LaPorta","1B",291,967,106,230,53,2,31,120,82,223,3,0,0.238,0.301,0.393,0.69039406220333,380,0.155,0.367713004484305,3,100,1049,226,0.297426120114395,0.392967942088935,31.1935483870968
"H Conger","C",373,1013,94,224,50,2,31,114,97,267,0,4,0.221,0.294,0.366,0.655428083562338,371,0.145,0.363295880149813,4,0,1110,208,0.289189189189189,0.366238894373149,32.6774193548387
"B Shindle","3B",1422,5807,992,1561,226,97,31,758,388,240,318,0,0.269,0.323,0.357,0.671763712854973,2074,0.088,1.61666666666667,318,100,6195,1750,0.314608555286521,0.357155157568452,187.322580645161
"E Dukes","CF",240,824,113,199,39,8,31,123,129,197,18,18,0.242,0.349,0.421,0.76529279026885,347,0.179,0.654822335025381,36,50,953,236,0.344176285414481,0.421116504854369,26.5806451612903
"B Kerr","SS",1067,3631,376,903,145,25,31,333,324,280,38,0,0.249,0.312,0.328,0.638249015274774,1191,0.079,1.15714285714286,38,100,3955,709,0.310240202275601,0.328008812999174,117.129032258065
"C Carroll","LF",991,3972,729,995,125,47,31,423,361,290,197,0,0.251,0.32,0.329,0.64200052339606,1307,0.078,1.2448275862069,197,100,4333,1152,0.312947149780752,0.329053373615307,128.129032258065
"F Kendall","C",877,2576,170,603,86,11,31,244,189,240,5,5,0.234,0.285,0.312,0.598549414262127,804,0.078,0.7875,10,50,2765,414,0.286437613019892,0.312111801242236,83.0967741935484
"R Guzm?n","1B",246,743,91,167,39,3,31,104,73,243,3,2,0.225,0.302,0.41,0.704615628216293,305,0.185,0.300411522633745,5,60,816,195,0.294117647058824,0.41049798115747,23.9677419354839
"D Strange","3B",707,1859,194,434,87,7,31,211,155,330,14,15,0.233,0.295,0.338,0.630268860312402,628,0.105,0.46969696969697,29,48.2758620689655,2014,405,0.292452830188679,0.337816030123722,59.9677419354839
"L Berberet","C",448,1224,118,281,34,10,31,153,200,195,2,3,0.23,0.337,0.35,0.687454101490784,428,0.12,1.02564102564103,5,40,1424,271,0.337780898876405,0.349673202614379,39.4838709677419
"N Williams","OF",294,836,109,210,30,7,31,110,57,255,4,4,0.251,0.312,0.415,0.714063931589128,347,0.164,0.223529411764706,8,50,893,219,0.298992161254199,0.415071770334928,26.9677419354839
"D Wise","CF",576,1109,149,253,45,16,31,115,46,245,55,13,0.228,0.264,0.381,0.640299165817651,423,0.153,0.187755102040816,68,80.8823529411765,1155,264,0.258874458874459,0.381424706943192,35.7741935483871
"J Hornung","LF",1123,4784,788,1230,172,90,31,564,120,498,159,0,0.257,0.277,0.35,0.625410899300005,1675,0.093,0.240963855421687,159,100,4904,1352,0.275285481239804,0.350125418060201,154.322580645161
"S Le?n","C",535,1508,154,316,60,2,31,145,132,435,1,1,0.21,0.278,0.314,0.586831209160898,473,0.104,0.303448275862069,2,50,1640,299,0.273170731707317,0.313660477453581,48.6451612903226
"D Barney","2B",814,2536,297,625,117,15,31,201,155,349,29,9,0.246,0.294,0.341,0.630943400539478,865,0.095,0.444126074498567,38,76.3157894736842,2691,498,0.289855072463768,0.34108832807571,81.8064516129032
"P Herrera","1B",300,975,122,264,46,8,31,128,113,271,8,6,0.271,0.349,0.43,0.776250942684766,419,0.159,0.416974169741697,14,57.1428571428571,1088,250,0.346507352941176,0.42974358974359,31.4516129032258
"T Brown","SS",494,1280,151,309,39,7,31,159,85,142,7,4,0.241,0.292,0.355,0.644113438644689,455,0.114,0.598591549295775,11,63.6363636363636,1365,310,0.288644688644689,0.35546875,41.2903225806452
"R Hemsley","C",1593,5047,562,1321,257,72,31,555,357,395,29,18,0.262,0.311,0.36,0.67013030877626,1815,0.098,0.90379746835443,47,61.7021276595745,5404,1117,0.310510732790526,0.359619575985734,162.806451612903
"T Hartsel","LF",1287,4848,826,1336,182,92,31,341,837,0,247,0,0.276,0.384,0.37,0.752489724566124,1795,0.094,Inf,247,100,5685,1167,0.382233948988566,0.370255775577558,156.387096774194
"J Manto","3B",289,713,97,164,35,2,31,97,97,182,3,6,0.23,0.329,0.415,0.737369487299361,296,0.185,0.532967032967033,9,33.3333333333333,810,194,0.322222222222222,0.415147265077139,23
"R Nelson","1B",620,1394,186,347,61,14,31,173,130,94,7,3,0.249,0.317,0.379,0.692475626701612,529,0.13,1.38297872340426,10,70,1524,359,0.312992125984252,0.37948350071736,44.9677419354839
"K Nieuwenhuis","CF",414,978,128,216,59,4,31,117,123,366,20,15,0.221,0.311,0.384,0.69235998506656,376,0.163,0.336065573770492,35,57.1428571428571,1101,245,0.307901907356948,0.384458077709611,31.5483870967742
"M Alou","CF",1667,5789,780,1777,236,50,31,427,311,377,156,80,0.307,0.345,0.381,0.723362623857004,2206,0.074,0.824933687002653,236,66.1016949152542,6100,1207,0.342295081967213,0.381067541889791,186.741935483871
"J Bartlett","SS",892,3141,435,849,156,26,31,286,275,526,123,37,0.27,0.336,0.366,0.695165250405046,1150,0.096,0.522813688212928,160,76.875,3416,721,0.32903981264637,0.366125437758676,101.322580645161
"J Stahl","1B",982,3425,405,894,149,87,31,437,221,1,178,0,0.261,0.323,0.382,0.688296343157785,1310,0.121,221,178,100,3646,842,0.305814591332968,0.382481751824818,110.483870967742
"J Lagares","RF",850,2329,270,582,119,22,31,217,120,528,45,19,0.25,0.291,0.36,0.646458688985664,838,0.11,0.227272727272727,64,70.3125,2449,487,0.286647611269906,0.359811077715758,75.1290322580645
"C Salmon","2B",658,1667,202,415,70,6,31,149,89,233,46,24,0.249,0.29,0.354,0.640945159487465,590,0.105,0.381974248927039,70,65.7142857142857,1756,351,0.287015945330296,0.353929214157169,53.7741935483871
"V Caratini","C",459,1190,127,276,49,0,31,146,123,296,3,1,0.232,0.316,0.351,0.655144738778985,418,0.119,0.415540540540541,4,75,1313,273,0.303884234577304,0.351260504201681,38.3870967741936
"B Salkeld","C",356,850,111,232,39,2,31,132,182,101,6,0,0.273,0.402,0.433,0.834103967168263,368,0.16,1.8019801980198,6,100,1032,243,0.401162790697674,0.432941176470588,27.4193548387097
"M Cross","SS",856,5821,718,1364,232,68,31,621,616,100,328,0,0.234,0.316,0.314,0.621116720283657,1825,0.08,6.16,328,100,6437,1339,0.307596706540314,0.313520013743343,187.774193548387
"D Green","1B",489,1398,168,374,48,18,31,180,84,278,68,35,0.268,0.308,0.394,0.70317631318309,551,0.126,0.302158273381295,103,66.0194174757282,1482,348,0.309041835357625,0.394134477825465,45.0967741935484
"B Speake","OF",305,761,110,170,26,10,31,104,80,158,8,11,0.223,0.301,0.406,0.703309838578377,309,0.183,0.506329113924051,19,42.1052631578947,841,214,0.297265160523187,0.406044678055191,24.5483870967742
"E Grace","C",627,1877,169,493,83,10,31,251,185,130,1,0,0.263,0.331,0.367,0.695882103383291,689,0.104,1.42307692307692,1,100,2062,420,0.328806983511154,0.367075119872136,60.5483870967742
"J Tinker","SS",1652,6434,774,1687,263,114,31,782,416,149,336,0,0.262,0.308,0.353,0.659975903559784,2271,0.091,2.79194630872483,336,100,6850,1556,0.307007299270073,0.352968604289711,207.548387096774
"C Tierney","2B",630,2299,266,681,119,30,31,331,109,187,28,31,0.296,0.332,0.415,0.742601145377378,953,0.119,0.582887700534759,59,47.4576271186441,2408,597,0.328073089700997,0.414528055676381,74.1612903225806
"J Corkhill","CF",1086,4404,650,1120,110,80,31,631,174,80,137,0,0.254,0.288,0.337,0.619395509622493,1483,0.083,2.175,137,100,4578,1281,0.282656181738751,0.336739327883742,142.064516129032
"C Warwick","OF",530,1462,168,363,51,10,31,149,127,241,13,6,0.248,0.307,0.36,0.668835160331933,527,0.112,0.526970954356846,19,68.4210526315789,1589,317,0.308370044052863,0.36046511627907,47.1612903225806
"M Mota","LF",1536,3779,496,1149,125,52,31,438,289,320,50,42,0.304,0.355,0.389,0.742747075841939,1471,0.085,0.903125,92,54.3478260869565,4068,934,0.353490658800393,0.389256417041545,121.903225806452
"L Bigbie","LF",392,1227,164,328,56,4,31,137,119,302,25,8,0.267,0.331,0.395,0.727368120217348,485,0.128,0.394039735099338,33,75.7575757575758,1346,301,0.332095096582467,0.395273023634882,39.5806451612903
"J Liefer","1B",288,779,89,179,36,1,31,113,56,223,2,2,0.23,0.281,0.398,0.679383210472508,310,0.168,0.251121076233184,4,50,835,202,0.281437125748503,0.397946084724005,25.1290322580645
"D Foutz","1B",1135,4533,784,1253,186,91,31,749,300,136,280,0,0.276,0.323,0.378,0.699448543634014,1714,0.102,2.20588235294118,280,100,4833,1533,0.321332505690048,0.378116037943966,146.225806451613
"L Fonseca","1B",937,3404,518,1075,203,50,31,485,186,199,64,36,0.316,0.355,0.432,0.78339214229368,1471,0.116,0.934673366834171,100,64,3590,1003,0.35125348189415,0.43213866039953,109.806451612903
"E Kratz","C",335,881,76,184,36,0,31,105,47,208,1,0,0.209,0.256,0.355,0.604200506869153,313,0.146,0.225961538461538,1,100,928,181,0.248922413793103,0.35527809307605,28.4193548387097
"L Finney","RF",1270,4631,643,1329,203,85,31,494,329,186,39,45,0.287,0.336,0.388,0.72187946238881,1795,0.101,1.76881720430108,84,46.4285714285714,4960,1137,0.334274193548387,0.387605268840423,149.387096774194
"L Rengifo","2B",325,1118,127,263,42,7,31,106,84,236,12,8,0.235,0.295,0.369,0.657200729850964,412,0.134,0.355932203389831,20,60,1202,233,0.288685524126456,0.368515205724508,36.0645161290323
"K Boswell","2B",930,2517,266,625,91,19,31,244,240,239,27,17,0.248,0.313,0.337,0.650258546562375,847,0.089,1.00418410041841,44,61.3636363636364,2757,510,0.313746826260428,0.336511720301947,81.1935483870968
"J Lefebvre","RF",447,1091,139,281,52,13,31,130,139,204,11,9,0.258,0.344,0.414,0.755762223066777,452,0.156,0.681372549019608,20,55,1230,269,0.341463414634146,0.414298808432631,35.1935483870968
"L Lee","LF",614,1617,173,404,83,13,31,152,133,315,19,14,0.25,0.307,0.375,0.681625231910946,606,0.125,0.422222222222222,33,57.5757575757576,1750,325,0.306857142857143,0.374768089053803,52.1612903225806
"B Rodgers","C",932,3033,259,704,114,18,31,288,234,409,17,27,0.232,0.288,0.312,0.59934567325989,947,0.08,0.572127139364303,44,38.6363636363636,3267,547,0.287113559840833,0.312232113419057,97.8387096774194
"D Engle","C",594,1643,201,431,88,13,31,181,120,190,5,5,0.262,0.311,0.388,0.700849510582892,638,0.126,0.631578947368421,10,50,1763,382,0.312535450935905,0.388314059646987,53
"T Taylor","CF",250,664,89,160,36,6,31,101,45,170,9,3,0.241,0.303,0.453,0.742452886298367,301,0.212,0.264705882352941,12,75,709,190,0.289139633286319,0.453313253012048,21.4193548387097
"R Ducey","LF",703,1279,190,309,78,13,31,146,166,346,22,17,0.242,0.331,0.396,0.724341302542265,506,0.154,0.479768786127168,39,56.4102564102564,1445,336,0.328719723183391,0.395621579358874,41.258064516129
"A Romine","C",485,1352,141,311,64,1,31,166,69,366,4,1,0.23,0.268,0.348,0.615050447846962,470,0.118,0.188524590163934,5,80,1421,307,0.267417311752287,0.347633136094675,43.6129032258064
"V Robles","CF",483,1485,196,347,73,10,31,146,101,400,58,23,0.234,0.307,0.359,0.641394185656481,533,0.125,0.2525,81,71.6049382716049,1586,342,0.282471626733922,0.358922558922559,47.9032258064516
"M Diaz","1B",293,683,70,169,27,2,31,102,71,128,1,2,0.247,0.319,0.429,0.747292138366001,293,0.182,0.5546875,3,33.3333333333333,754,172,0.318302387267904,0.428989751098097,22.0322580645161
"K Higashioka","C",223,620,71,124,25,0,31,88,37,170,0,1,0.2,0.245,0.39,0.635375853095694,242,0.19,0.217647058823529,1,0,657,159,0.245053272450533,0.390322580645161,20
"E Chavez","CF",1151,3149,385,849,140,34,30,266,180,356,106,42,0.27,0.308,0.364,0.673344449085812,1147,0.094,0.50561797752809,148,71.6216216216216,3329,651,0.309101832382097,0.364242616703715,104.966666666667
"M Kingery","CF",819,2034,292,546,108,26,30,219,191,248,45,28,0.268,0.33,0.391,0.722583054367881,796,0.123,0.770161290322581,73,61.6438356164384,2225,511,0.33123595505618,0.391347099311701,67.8
"R Hanigan","C",680,1959,192,492,71,1,30,214,255,290,1,1,0.251,0.344,0.334,0.671752636362505,655,0.083,0.879310344827586,2,50,2214,406,0.33739837398374,0.334354262378765,65.3
"B Wine","SS",1164,3172,249,682,104,16,30,268,214,538,7,7,0.215,0.264,0.286,0.550873748369706,908,0.071,0.397769516728625,14,50,3386,517,0.264619019492026,0.28625472887768,105.733333333333
"T Kemp","2B",613,1585,220,386,75,12,30,158,185,260,38,12,0.244,0.33,0.363,0.68537489529309,575,0.119,0.711538461538462,50,76,1770,378,0.322598870056497,0.362776025236593,52.8333333333333
"V Joshua","CF",822,2234,277,610,87,31,30,184,108,338,55,40,0.273,0.306,0.38,0.68661138663631,849,0.107,0.319526627218935,95,57.8947368421053,2342,461,0.306575576430401,0.380035810205909,74.4666666666667
"C Culberson","3B",589,1211,140,300,61,8,30,145,68,337,21,10,0.248,0.293,0.386,0.673356494319403,467,0.138,0.201780415430267,31,67.741935483871,1279,285,0.287724784988272,0.385631709331131,40.3666666666667
"C Ransom","SS",383,752,111,160,47,2,30,105,88,274,6,3,0.213,0.303,0.4,0.695504052684904,301,0.187,0.321167883211679,9,66.6666666666667,840,216,0.295238095238095,0.400265957446808,25.0666666666667
"J Canavan","RF",539,2064,322,461,63,48,30,287,230,147,114,0,0.223,0.304,0.344,0.645212823476139,710,0.121,1.56462585034014,114,100,2294,609,0.301220575414124,0.343992248062016,68.8
"C Jones","RF",548,1021,155,257,43,11,30,131,74,287,26,10,0.252,0.303,0.404,0.705809059968962,412,0.152,0.257839721254355,36,72.2222222222222,1095,286,0.302283105022831,0.403525954946131,34.0333333333333
"R Santiago","SS",920,2436,295,592,85,18,30,214,203,420,30,15,0.243,0.314,0.33,0.630889225716812,803,0.087,0.483333333333333,45,66.6666666666667,2639,509,0.301250473664267,0.329638752052545,81.2
"P Valaika","2B",374,802,91,177,34,1,30,92,47,235,1,3,0.221,0.264,0.378,0.641645297827281,303,0.157,0.2,4,25,849,183,0.263839811542992,0.377805486284289,26.7333333333333
"J Phillips","C",465,1382,138,344,77,0,30,168,111,170,0,5,0.249,0.314,0.37,0.674509505526514,511,0.121,0.652941176470588,5,0,1493,306,0.304755525787006,0.369753979739508,46.0666666666667
"E Burke","LF",853,3508,744,979,142,57,30,410,317,228,291,0,0.279,0.352,0.378,0.716531625192837,1325,0.099,1.39035087719298,291,100,3825,1154,0.338823529411765,0.377708095781072,116.933333333333
"L Matuszek","1B",378,820,113,192,40,5,30,119,88,168,8,10,0.234,0.309,0.405,0.713248092833351,332,0.171,0.523809523809524,18,44.4444444444444,908,232,0.308370044052863,0.404878048780488,27.3333333333333
"C Parmelee","1B",311,917,89,227,48,3,30,98,79,239,1,5,0.248,0.313,0.405,0.711809068334406,371,0.157,0.330543933054393,6,16.6666666666667,996,187,0.307228915662651,0.404580152671756,30.5666666666667
"D Rader","C",846,2405,254,619,107,12,30,235,245,180,8,4,0.257,0.326,0.349,0.675310085121406,840,0.092,1.36111111111111,12,66.6666666666667,2650,489,0.326037735849057,0.349272349272349,80.1666666666667
"S Brye","CF",697,1997,237,515,97,13,30,193,144,276,16,14,0.258,0.309,0.365,0.672346913644638,728,0.107,0.521739130434783,30,53.3333333333333,2141,430,0.307800093414292,0.364546820230346,66.5666666666667
"B Browne","LF",349,869,94,205,37,10,30,102,101,273,5,6,0.236,0.318,0.405,0.720527208665014,352,0.169,0.36996336996337,11,45.4545454545455,970,196,0.315463917525773,0.40506329113924,28.9666666666667
"D Heep","RF",883,1961,208,503,96,6,30,229,220,242,12,14,0.257,0.33,0.357,0.688969990467486,701,0.1,0.909090909090909,26,46.1538461538462,2181,437,0.331499312242091,0.357470678225395,65.3666666666667
"L Matos","RF",508,1605,212,410,84,9,30,140,108,297,72,24,0.255,0.312,0.375,0.677471343382927,602,0.12,0.363636363636364,96,75,1713,352,0.302393461762989,0.375077881619938,53.5
"F Brower","RF",452,1297,206,371,74,20,30,205,168,84,17,14,0.286,0.379,0.443,0.811248852037124,575,0.157,2,31,54.8387096774194,1465,411,0.367918088737201,0.443330763299923,43.2333333333333
"N Hanlon","CF",1267,5074,930,1317,159,79,30,517,471,357,329,0,0.26,0.325,0.34,0.66222404357795,1724,0.08,1.31932773109244,329,100,5545,1447,0.322452660054103,0.339771383523847,169.133333333333
"J Brohamer","2B",805,2500,262,613,91,12,30,227,221,178,9,17,0.245,0.305,0.327,0.633704961411246,818,0.082,1.24157303370787,26,34.6153846153846,2721,489,0.306504961411246,0.3272,83.3333333333333
"S Hale","3B",884,2915,422,880,157,54,30,392,130,218,41,20,0.302,0.336,0.424,0.755361966162226,1235,0.122,0.596330275229358,61,67.2131147540984,3045,814,0.331691297208539,0.423670668953688,97.1666666666667
"J Hairston","LF",859,1699,216,438,91,6,30,205,282,240,4,4,0.258,0.362,0.371,0.734847739814286,631,0.113,1.175,8,50,1981,421,0.363452801615346,0.371394938198941,56.6333333333333
"C Neeman","C",376,1002,93,224,35,4,30,97,79,221,1,0,0.224,0.284,0.356,0.636583447351366,357,0.132,0.357466063348416,1,100,1081,190,0.280296022201665,0.356287425149701,33.4
"P Mackanin","2B",548,1570,161,355,63,12,30,141,76,290,27,12,0.226,0.263,0.339,0.6007004047643,532,0.113,0.262068965517241,39,69.2307692307692,1646,302,0.261846901579587,0.338853503184713,52.3333333333333
"W Cruise","LF",737,2321,293,644,83,39,30,272,238,250,49,15,0.277,0.348,0.386,0.730275536123866,895,0.109,0.952,64,76.5625,2559,565,0.344665885111372,0.385609651012495,77.3666666666667
"D Zwilling","OF",63,1280,167,364,76,15,30,202,128,139,46,0,0.284,0.351,0.438,0.786931818181818,560,0.154,0.920863309352518,46,100,1408,369,0.349431818181818,0.4375,42.6666666666667
"D Barton","1B",551,1744,242,431,94,11,30,184,290,348,13,7,0.247,0.356,0.365,0.7197262365475,637,0.118,0.833333333333333,20,65,2034,426,0.354473942969518,0.365252293577982,58.1333333333333
"J Gosger","CF",706,1815,197,411,67,16,30,177,217,316,25,18,0.226,0.309,0.331,0.63963363050693,600,0.105,0.686708860759494,43,58.1395348837209,2032,374,0.309055118110236,0.330578512396694,60.5
"E Goodson","1B",515,1266,108,329,51,2,30,170,63,135,1,3,0.26,0.297,0.374,0.669366198438765,474,0.114,0.466666666666667,4,25,1329,278,0.294958615500376,0.374407582938389,42.2
"S Kingery","2B",325,1042,132,239,62,6,30,96,67,320,25,7,0.229,0.28,0.387,0.662680494090403,403,0.158,0.209375,32,78.125,1109,228,0.275924256086564,0.386756238003839,34.7333333333333
"A Engel","CF",523,1413,173,318,65,11,30,123,76,450,47,17,0.225,0.28,0.35,0.614925590209306,495,0.125,0.168888888888889,64,73.4375,1489,296,0.264607118871726,0.35031847133758,47.1
"J Cora","2B",1119,3734,624,1035,171,41,30,294,380,336,117,60,0.277,0.348,0.369,0.712988738989157,1378,0.092,1.13095238095238,177,66.1016949152542,4114,918,0.343947496353913,0.369041242635244,124.466666666667
"C Perkins","C",1171,3604,329,933,175,35,30,409,301,221,18,34,0.259,0.319,0.352,0.667836420196083,1268,0.093,1.36199095022624,52,34.6153846153846,3905,738,0.316005121638924,0.351831298557159,120.133333333333
"A Fox","SS",776,1925,248,461,65,17,30,168,197,407,74,25,0.239,0.324,0.338,0.64774716329853,650,0.099,0.484029484029484,99,74.7474747474748,2122,416,0.310084825636192,0.337662337662338,64.1666666666667
"B Roth","RF",811,2831,427,804,138,73,30,422,335,389,189,41,0.284,0.367,0.416,0.77586733201338,1178,0.132,0.861182519280206,230,82.1739130434783,3166,849,0.359759949463045,0.416107382550336,94.3666666666667
"J Wendle","SS",541,1817,232,490,112,15,30,199,112,362,54,18,0.27,0.321,0.397,0.709437080188177,722,0.127,0.30939226519337,72,75,1929,431,0.312078797304303,0.397358282883875,60.5666666666667
"G Pena","2B",378,1010,162,265,60,8,30,124,112,255,54,22,0.262,0.345,0.427,0.762739803392104,431,0.165,0.43921568627451,76,71.0526315789474,1122,286,0.336007130124777,0.426732673267327,33.6666666666667
"T Eusebio","C",598,1739,180,479,87,5,30,241,182,324,1,5,0.275,0.346,0.383,0.72707034235272,666,0.108,0.561728395061728,6,16.6666666666667,1921,421,0.344091618948464,0.382978723404255,57.9666666666667
"J Marte","1B",256,659,85,146,30,1,30,91,52,156,4,3,0.222,0.288,0.407,0.68515779566278,268,0.185,0.333333333333333,7,57.1428571428571,711,176,0.278481012658228,0.406676783004552,21.9666666666667
"M Rocco","1B",440,1721,219,444,73,17,30,186,174,146,6,15,0.258,0.327,0.372,0.698579245361122,641,0.114,1.19178082191781,21,28.5714285714286,1895,405,0.326121372031662,0.37245787332946,57.3666666666667
"T Moore","LF",381,788,75,180,46,0,30,121,50,234,3,0,0.228,0.278,0.401,0.6754782355863,316,0.173,0.213675213675214,3,100,838,196,0.274463007159905,0.401015228426396,26.2666666666667
"D Dyer","C",722,1993,151,441,74,11,30,173,228,415,10,4,0.221,0.306,0.315,0.615816772481262,627,0.094,0.549397590361446,14,71.4285714285714,2221,324,0.30121566861774,0.314601103863522,66.4333333333333
"L Skizas","OF",239,725,80,196,27,4,30,86,50,37,8,3,0.27,0.317,0.443,0.760177975528365,321,0.173,1.35135135135135,11,72.7272727272727,775,166,0.31741935483871,0.442758620689655,24.1666666666667
"B Roberts","2B",1202,4147,663,1220,203,31,30,352,396,548,264,95,0.294,0.358,0.38,0.735504705697575,1575,0.086,0.722627737226277,359,73.5376044568245,4543,1015,0.355712084525644,0.379792621171932,138.233333333333
"M Duffy","3B",627,2137,254,598,94,9,30,217,162,399,40,14,0.28,0.337,0.374,0.704935087034036,800,0.094,0.406015037593985,54,74.0740740740741,2299,471,0.330578512396694,0.374356574637342,71.2333333333333
"S Van Slyke","LF",355,760,84,184,44,1,29,95,85,223,11,6,0.242,0.326,0.417,0.735448458424167,317,0.175,0.381165919282511,17,64.7058823529412,845,179,0.318343195266272,0.417105263157895,26.2068965517241
"D Kolloway","2B",1079,3993,466,1081,180,30,29,393,189,251,76,54,0.271,0.305,0.353,0.656299528478999,1408,0.082,0.752988047808765,130,58.4615384615385,4182,859,0.303682448589192,0.352617079889807,137.689655172414
"A Garc?a","3B",244,896,104,239,45,0,29,110,36,151,7,2,0.267,0.3,0.414,0.709126877682403,371,0.147,0.23841059602649,9,77.7777777777778,932,214,0.295064377682403,0.4140625,30.8965517241379
"B Caruthers","P",705,2465,508,695,104,50,29,359,417,79,152,0,0.282,0.391,0.4,0.785843164469119,986,0.118,5.27848101265823,152,100,2882,867,0.385843164469119,0.4,85
"W Kamm","3B",1693,5851,802,1643,348,85,29,826,824,405,126,84,0.281,0.372,0.384,0.75379584270303,2248,0.103,2.03456790123457,210,60,6675,1628,0.369588014981273,0.384207827721757,201.758620689655
"B Sullivan","C",962,2840,347,820,152,32,29,388,240,119,30,24,0.289,0.346,0.395,0.739578379367112,1123,0.106,2.01680672268908,54,55.5555555555556,3080,735,0.344155844155844,0.395422535211268,97.9310344827586
"L Biittner","1B",1217,3151,310,861,144,20,29,354,236,287,10,12,0.273,0.324,0.359,0.683136475764626,1132,0.086,0.822299651567944,22,45.4545454545455,3387,664,0.323885444346029,0.359251031418597,108.655172413793
"L Olmo","CF",462,1629,208,458,65,25,29,272,88,128,33,1,0.281,0.319,0.405,0.723153043286129,660,0.124,0.6875,34,97.0588235294118,1717,480,0.317996505532906,0.405156537753223,56.1724137931034
"D Carlson","CF",314,1088,147,271,68,9,29,123,110,281,8,4,0.249,0.325,0.408,0.72611828537759,444,0.159,0.391459074733096,12,66.6666666666667,1198,270,0.318030050083472,0.408088235294118,37.5172413793103
"C James","RF",510,1406,158,358,56,9,29,172,48,260,7,7,0.255,0.283,0.369,0.6483620013266,519,0.114,0.184615384615385,14,50,1454,330,0.279229711141678,0.369132290184922,48.4827586206897
"J Hummel","2B",1158,3906,421,991,128,84,29,394,346,269,117,1,0.254,0.316,0.352,0.666206776462292,1374,0.098,1.28624535315985,118,99.1525423728814,4252,815,0.314440263405456,0.351766513056836,134.689655172414
"K Oberkfell","3B",1602,4874,558,1354,237,44,29,446,546,356,62,47,0.278,0.351,0.362,0.712884240044698,1766,0.084,1.53370786516854,109,56.8807339449541,5420,1004,0.350553505535055,0.362330734509643,168.068965517241
"D Williams","2B",476,1574,198,421,74,12,29,201,133,140,7,3,0.267,0.327,0.385,0.709552340352045,606,0.118,0.95,10,70,1707,399,0.324545987111892,0.385006353240152,54.2758620689655
"P Householder","RF",466,1326,146,313,60,11,29,144,126,250,36,29,0.236,0.304,0.363,0.66584084364833,482,0.127,0.504,65,55.3846153846154,1452,290,0.302341597796143,0.363499245852187,45.7241379310345
"S Stirnweiss","2B",1028,3695,604,989,157,68,29,281,541,447,134,55,0.268,0.362,0.371,0.731690478289703,1369,0.103,1.21029082774049,189,70.8994708994709,4236,885,0.361189801699717,0.370500676589986,127.413793103448
"J Quinn","2B",66,6879,891,1797,228,70,29,794,364,214,268,0,0.261,0.302,0.327,0.625730199082192,2252,0.066,1.70093457943925,268,100,7243,1685,0.29835703437802,0.327373164704172,237.206896551724
"J Marshall","1B",411,852,111,206,24,7,29,106,101,139,5,4,0.242,0.32,0.388,0.710638261186567,331,0.146,0.726618705035971,9,55.5555555555556,953,217,0.322140608604407,0.38849765258216,29.3793103448276
"A Presley","LF",450,1401,157,369,50,19,29,111,81,282,30,18,0.263,0.306,0.388,0.691937800356599,544,0.125,0.287234042553192,48,62.5,1482,268,0.303643724696356,0.388294075660243,48.3103448275862
"M Murton","LF",346,952,134,272,46,5,29,112,93,149,10,3,0.286,0.352,0.436,0.785206666398617,415,0.15,0.624161073825503,13,76.9230769230769,1045,246,0.349282296650718,0.435924369747899,32.8275862068966
"C Raleigh","C",170,523,52,107,34,1,29,80,45,175,1,0,0.205,0.269,0.44,0.707376188296125,230,0.235,0.257142857142857,1,100,568,132,0.267605633802817,0.439770554493308,18.0344827586207
"B Hargrave","C",853,2533,314,786,155,58,29,376,217,165,29,16,0.31,0.372,0.452,0.816365646197466,1144,0.142,1.31515151515152,45,64.4444444444444,2750,690,0.364727272727273,0.451638373470193,87.3448275862069
"R Martinez","SS",798,1952,223,512,98,10,29,242,170,267,10,7,0.262,0.321,0.367,0.68871048423232,717,0.105,0.636704119850187,17,58.8235294117647,2122,465,0.321394910461828,0.367315573770492,67.3103448275862
"E Stanky","2B",1259,4301,812,1154,185,35,29,364,996,374,48,5,0.268,0.41,0.348,0.753716213443212,1496,0.08,2.66310160427807,53,90.5660377358491,5297,1176,0.405890126486691,0.347826086956522,148.310344827586
"R Quinones","SS",451,1533,173,373,75,6,29,159,89,240,5,11,0.243,0.287,0.357,0.64165023812339,547,0.114,0.370833333333333,16,31.25,1622,332,0.284833538840937,0.356816699282453,52.8620689655172
"C Frazier","LF",247,744,104,177,44,5,29,98,92,246,8,2,0.238,0.329,0.427,0.749189689766939,318,0.189,0.373983739837398,10,80,836,202,0.32177033492823,0.42741935483871,25.6551724137931
"G Briley","LF",598,1518,172,384,75,9,29,135,124,260,65,25,0.253,0.31,0.372,0.680920308310024,564,0.119,0.476923076923077,90,72.2222222222222,1642,307,0.309378806333739,0.371541501976285,52.3448275862069
"C Spangenberg","3B",420,1250,154,320,49,15,29,119,99,374,34,10,0.256,0.315,0.389,0.699400444773907,486,0.133,0.264705882352941,44,77.2727272727273,1349,273,0.310600444773907,0.3888,43.1034482758621
"D Green","RF",657,3484,552,1021,124,65,29,423,315,0,192,0,0.293,0.359,0.391,0.742601458054857,1362,0.098,Inf,192,100,3799,975,0.351671492498026,0.390929965556831,120.137931034483
"R Ashburn","CF",2189,8365,1322,2574,317,109,29,586,1198,571,234,92,0.308,0.396,0.382,0.776505033252601,3196,0.074,2.09807355516637,326,71.7791411042945,9563,1908,0.394436892188644,0.382068141063957,288.448275862069
"J Tipton","C",417,1117,116,264,36,5,29,125,186,142,3,3,0.236,0.351,0.355,0.700773162408078,397,0.119,1.30985915492958,6,50,1303,241,0.34535686876439,0.355416293643688,38.5172413793103
"R Russell","1B",425,1402,133,344,52,8,29,192,83,142,4,1,0.245,0.289,0.356,0.643462201664769,499,0.111,0.584507042253521,5,80,1485,325,0.287542087542088,0.355920114122682,48.3448275862069
"V Correll","C",410,1132,124,259,60,4,29,125,128,220,2,8,0.229,0.31,0.366,0.672867238768299,414,0.137,0.581818181818182,10,20,1260,249,0.307142857142857,0.365724381625442,39.0344827586207
"J Wasdell","LF",888,2866,339,782,109,34,29,341,243,165,29,4,0.273,0.332,0.365,0.694656599921395,1046,0.092,1.47272727272727,33,87.8787878787879,3109,680,0.329688002573175,0.364968597348221,98.8275862068966
"J Hannahan","3B",614,1650,167,381,93,5,29,175,193,440,6,4,0.231,0.314,0.346,0.657509330965652,571,0.115,0.438636363636364,10,60,1843,342,0.311448724905046,0.346060606060606,56.8965517241379
"L Thomas","RF",278,810,109,194,44,5,29,94,86,217,15,8,0.24,0.315,0.414,0.72608024691358,335,0.174,0.3963133640553,23,65.2173913043478,896,203,0.3125,0.41358024691358,27.9310344827586
"S Hilliard","CF",215,570,85,121,19,7,29,71,65,209,16,1,0.212,0.295,0.423,0.715720403370631,241,0.211,0.311004784688995,17,94.1176470588235,635,156,0.292913385826772,0.42280701754386,19.6551724137931
"L Fleming","1B",434,1330,168,369,69,15,29,199,226,152,7,8,0.277,0.386,0.417,0.799683978583992,555,0.14,1.48684210526316,15,46.6666666666667,1556,367,0.382390745501285,0.417293233082707,45.8620689655172
"C Comiskey","1B",1390,5796,994,1530,206,68,29,883,197,84,419,0,0.264,0.293,0.338,0.626161249546141,1959,0.074,2.3452380952381,419,100,5993,1877,0.28816953111964,0.337991718426501,199.862068965517
"F Throneberry","RF",521,1302,152,307,48,12,29,137,127,284,23,14,0.236,0.307,0.358,0.661619793631803,466,0.122,0.447183098591549,37,62.1621621621622,1429,289,0.3037088873338,0.357910906298003,44.8965517241379
"D Nava","LF",589,1701,224,452,103,2,29,206,196,387,10,5,0.266,0.357,0.38,0.721368589347269,646,0.114,0.506459948320413,15,66.6666666666667,1897,430,0.341591987348445,0.379776601998824,58.6551724137931
"C Moeller","C",501,1392,146,315,74,7,29,132,108,331,2,4,0.226,0.288,0.352,0.634011494252874,490,0.126,0.326283987915408,6,33.3333333333333,1500,278,0.282,0.352011494252874,48
"D Drysdale","P",547,1169,96,218,26,7,29,113,60,370,0,2,0.186,0.228,0.295,0.521324200372938,345,0.109,0.162162162162162,2,0,1229,209,0.22620016273393,0.295124037639008,40.3103448275862
"B Cissell","2B",956,3707,516,990,173,43,29,423,212,250,113,63,0.267,0.308,0.36,0.667110140308884,1336,0.093,0.848,176,64.2045454545455,3919,939,0.306710895636642,0.360399244672242,127.827586206897
"T Douthit","CF",1074,4127,665,1201,220,38,29,396,443,312,67,3,0.291,0.364,0.384,0.743551326351152,1584,0.093,1.41987179487179,70,95.7142857142857,4570,1061,0.359737417943107,0.383813908408045,142.310344827586
"J Christopher","RF",638,1667,224,434,68,17,29,173,157,277,29,19,0.26,0.329,0.374,0.697738412843747,623,0.114,0.566787003610108,48,60.4166666666667,1824,397,0.324013157894737,0.37372525494901,57.4827586206897
"D Palka","1B",154,501,60,109,15,3,29,71,38,188,2,2,0.218,0.277,0.433,0.705861005262203,217,0.215,0.202127659574468,4,50,539,131,0.272727272727273,0.43313373253493,17.2758620689655
"J Charboneau","LF",201,647,97,172,26,4,29,114,61,99,3,4,0.266,0.329,0.453,0.781955396047817,293,0.187,0.616161616161616,7,42.8571428571429,708,211,0.32909604519774,0.452859350850077,22.3103448275862
"M McKenry","C",311,839,94,200,48,3,29,103,93,235,2,6,0.238,0.318,0.406,0.720813916014876,341,0.168,0.395744680851064,8,25,932,197,0.314377682403434,0.406436233611442,28.9310344827586
"J Rodr?guez","CF",136,529,86,151,27,3,29,77,40,151,26,8,0.285,0.344,0.512,0.847963960252624,271,0.227,0.264900662251656,34,76.4705882352941,569,163,0.335676625659051,0.512287334593573,18.2413793103448
"L Riggs","3B",760,2477,298,650,110,43,28,271,181,140,22,0,0.262,0.317,0.375,0.688095261963108,930,0.113,1.29285714285714,22,100,2658,569,0.312641083521445,0.375454178441663,88.4642857142857
"M Koenig","SS",1162,4271,571,1190,195,49,28,443,222,190,31,14,0.279,0.316,0.367,0.681159636288463,1567,0.088,1.16842105263158,45,68.8888888888889,4493,1014,0.314266636990875,0.366892999297588,152.535714285714
"B Knickerbocker","SS",907,3418,423,943,198,27,28,368,244,238,25,46,0.276,0.326,0.374,0.698335250236564,1279,0.098,1.02521008403361,71,35.2112676056338,3662,791,0.324139814309121,0.374195435927443,122.071428571429
"L Castillo","2B",1720,6510,1001,1889,194,59,28,443,800,850,370,142,0.29,0.368,0.351,0.718850721083632,2285,0.061,0.941176470588235,512,72.265625,7310,1444,0.367852257181943,0.35099846390169,232.5
"M Anderson","RF",721,1490,159,367,67,11,28,134,161,343,8,12,0.246,0.319,0.362,0.682222285456445,540,0.116,0.469387755102041,20,40,1651,293,0.319806178073895,0.36241610738255,53.2142857142857
"R Bernadina","LF",548,1323,159,312,56,8,28,121,121,315,59,12,0.236,0.307,0.354,0.653602992443515,468,0.118,0.384126984126984,71,83.0985915492958,1444,280,0.299861495844875,0.353741496598639,47.25
"C McCormick","CF",229,648,95,163,24,2,28,95,74,211,11,5,0.252,0.33,0.424,0.752637563694812,275,0.172,0.350710900473934,16,68.75,722,190,0.328254847645429,0.424382716049383,23.1428571428571
"B Bescher","LF",1228,4536,749,1171,190,74,28,345,619,451,428,31,0.258,0.353,0.351,0.698426169691931,1593,0.093,1.37250554323725,459,93.2461873638344,5155,1094,0.347235693501455,0.351190476190476,162
"B McKinney","OF",263,690,87,142,33,4,28,72,66,201,3,2,0.206,0.277,0.387,0.662088796871406,267,0.181,0.328358208955224,5,60,756,159,0.275132275132275,0.38695652173913,24.6428571428571
"R Ruiz","2B",315,849,95,180,33,3,28,109,90,220,5,3,0.212,0.287,0.357,0.644430395466194,303,0.145,0.409090909090909,8,62.5,939,204,0.287539936102236,0.356890459363958,30.3214285714286
"B Renna","RF",370,918,123,219,36,10,28,119,99,166,2,7,0.239,0.315,0.391,0.703751903908073,359,0.152,0.596385542168675,9,22.2222222222222,1017,242,0.312684365781711,0.391067538126362,32.7857142857143
"B Seeds","LF",615,1937,268,537,77,21,28,233,160,190,14,15,0.277,0.336,0.382,0.714413663199561,740,0.105,0.842105263157895,29,48.2758620689655,2097,501,0.33237958989032,0.382034073309241,69.1785714285714
"M Walbeck","C",682,2109,215,492,79,5,28,208,133,343,13,12,0.233,0.28,0.315,0.594084271604343,665,0.082,0.387755102040816,25,52,2242,423,0.278768956289028,0.315315315315315,75.3214285714286
"J Hodapp","2B",791,2826,378,880,169,34,28,429,163,136,18,20,0.311,0.35,0.425,0.773928442979294,1201,0.114,1.19852941176471,38,47.3684210526316,2989,807,0.348946135831382,0.424982307147912,100.928571428571
"L Wade Jr.","1B",232,661,94,152,29,5,28,89,77,163,9,3,0.23,0.322,0.416,0.726334411604328,275,0.186,0.47239263803681,12,75,738,183,0.31029810298103,0.416036308623298,23.6071428571429
"M Hoag","CF",1021,3147,384,854,141,33,28,401,252,298,59,49,0.271,0.328,0.364,0.689228396957441,1145,0.093,0.845637583892617,108,54.6296296296296,3399,785,0.325389820535452,0.363838576421989,112.392857142857
"E Stevens","1B",375,1220,134,308,59,17,28,193,121,151,7,0,0.252,0.322,0.398,0.717451498147944,485,0.146,0.801324503311258,7,100,1341,327,0.319910514541387,0.397540983606557,43.5714285714286
"T Herr","2B",1514,5349,676,1450,254,41,28,574,627,584,188,64,0.271,0.347,0.35,0.697154949954989,1870,0.079,1.0736301369863,252,74.6031746031746,5976,1250,0.347556894243641,0.349598055711348,191.035714285714
"W Belardi","1B",263,592,71,143,13,5,28,74,66,97,1,0,0.242,0.33,0.422,0.739926476628604,250,0.18,0.680412371134021,1,100,658,145,0.317629179331307,0.422297297297297,21.1428571428571
"H Martin","CF",607,2257,331,643,135,29,28,215,253,207,33,3,0.285,0.359,0.408,0.764592847043373,920,0.123,1.22222222222222,36,91.6666666666667,2510,546,0.356972111553785,0.407620735489588,80.6071428571429
"B Rodgers","2B",271,1011,130,269,54,6,28,123,69,218,0,0,0.266,0.318,0.414,0.727404110341796,419,0.148,0.31651376146789,0,0,1080,253,0.312962962962963,0.414441147378833,36.1071428571429
"J Treadway","2B",762,2119,244,596,103,14,28,208,140,184,14,13,0.281,0.326,0.383,0.708535581338847,811,0.102,0.760869565217391,27,51.8518518518518,2259,452,0.32580787959274,0.382727701746107,75.6785714285714
"R Maranville","SS",2670,10078,1255,2605,380,177,28,884,839,756,291,93,0.258,0.318,0.34,0.655122007669663,3423,0.082,1.10978835978836,384,75.78125,10917,2139,0.315471283319593,0.339650724350069,359.928571428571
"O Guillen","SS",1993,6686,773,1764,275,69,28,619,239,511,169,108,0.264,0.287,0.338,0.627411186260206,2261,0.074,0.467710371819961,277,61.0108303249097,6925,1392,0.289241877256318,0.338169309003889,238.785714285714
"D Hollins","RF",256,712,85,172,39,1,28,86,42,134,11,5,0.242,0.284,0.417,0.700954460107889,297,0.175,0.313432835820896,16,68.75,754,171,0.283819628647215,0.417134831460674,25.4285714285714
"B Grabarkewitz","3B",466,1161,189,274,41,12,28,141,202,321,33,17,0.236,0.351,0.364,0.713570725770217,423,0.128,0.629283489096573,50,66,1363,330,0.349229640498899,0.364341085271318,41.4642857142857
"W Contreras","C",156,520,70,135,19,2,28,72,58,166,2,0,0.26,0.336,0.465,0.799294649986692,242,0.205,0.349397590361446,2,100,578,142,0.333910034602076,0.465384615384615,18.5714285714286
"B Ashley","LF",281,618,56,144,23,1,28,84,63,236,0,0,0.233,0.307,0.409,0.71334987097786,253,0.176,0.266949152542373,0,0,681,140,0.303964757709251,0.409385113268608,22.0714285714286
"S Schumaker","2B",1149,3252,416,905,169,13,28,284,280,476,26,17,0.278,0.337,0.364,0.699587604596318,1184,0.086,0.588235294117647,43,60.4651162790698,3532,700,0.335503963759909,0.364083640836408,116.142857142857
"M Ryan","C",636,1920,146,370,60,12,28,161,152,370,4,4,0.193,0.252,0.28,0.532138835263835,538,0.087,0.410810810810811,8,50,2072,307,0.251930501930502,0.280208333333333,68.5714285714286
"J Mulvey","3B",987,4063,598,1059,157,71,28,532,134,257,147,0,0.261,0.287,0.355,0.639160820132707,1442,0.094,0.521400778210117,147,100,4197,1130,0.284250655229926,0.354910164902781,145.107142857143
"P Coscarart","2B",864,2992,399,728,129,22,28,269,295,361,34,0,0.243,0.314,0.329,0.640437271930096,985,0.086,0.817174515235457,34,100,3287,668,0.311226041983572,0.329211229946524,106.857142857143
"J McDonald","SS",1100,2434,276,568,105,14,28,210,118,379,34,19,0.233,0.273,0.323,0.591323157051488,785,0.09,0.311345646437995,53,64.1509433962264,2552,486,0.268808777429467,0.322514379622021,86.9285714285714
"O Smith","SS",2573,9396,1257,2460,402,69,28,793,1072,589,580,148,0.262,0.337,0.328,0.665634023730291,3084,0.066,1.82003395585739,728,79.6703296703297,10468,2050,0.337409247229652,0.328224776500639,335.571428571429
"J Rothrock","RF",1014,3350,498,924,162,35,28,327,299,312,75,33,0.276,0.336,0.37,0.705309571626657,1240,0.094,0.958333333333333,108,69.4444444444444,3649,825,0.335160317895314,0.370149253731343,119.642857142857
"J Rowe","SS",1044,4386,764,1256,202,88,28,644,224,177,59,0,0.286,0.323,0.392,0.712742081143611,1718,0.106,1.26553672316384,59,100,4610,1408,0.321041214750542,0.391700866393069,156.642857142857
"A Comorosky","LF",813,2787,404,795,134,51,28,417,214,158,57,0,0.285,0.339,0.4,0.736293021331127,1115,0.115,1.35443037974684,57,100,3001,821,0.33622125958014,0.400071761750987,99.5357142857143
"B Moran","2B",635,2076,242,545,88,10,28,202,133,218,10,8,0.263,0.308,0.355,0.661935844866551,737,0.092,0.610091743119266,18,55.5555555555556,2209,444,0.306926210955183,0.355009633911368,74.1428571428571
"R Ferrell","C",1884,6028,687,1692,324,45,28,734,931,277,29,35,0.281,0.378,0.363,0.740226550180682,2190,0.082,3.36101083032491,64,45.3125,6959,1421,0.376921971547636,0.363304578633046,215.285714285714
"S Leius","3B",557,1536,214,375,63,10,28,172,161,236,16,15,0.244,0.316,0.353,0.668716085985072,542,0.109,0.682203389830508,31,51.6129032258064,1697,386,0.315851502651738,0.352864583333333,54.8571428571429
"V Coleman","LF",1371,5406,849,1425,176,89,28,346,477,960,752,177,0.264,0.324,0.345,0.667921528631851,1863,0.081,0.496875,929,80.9472551130248,5883,1195,0.323304436511984,0.344617092119867,193.071428571429
"D Walton","LF",297,779,69,174,27,4,28,107,88,240,4,3,0.223,0.309,0.376,0.678314699737782,293,0.153,0.366666666666667,7,57.1428571428571,867,176,0.302191464821223,0.37612323491656,27.8214285714286
"B Phillips","CF",357,791,113,149,24,9,28,93,87,340,36,5,0.188,0.273,0.348,0.616453899075303,275,0.16,0.255882352941176,41,87.8048780487805,878,206,0.26879271070615,0.347661188369153,28.25
"A Pearson","CF",988,3077,485,831,130,24,28,214,477,195,77,33,0.27,0.369,0.355,0.723252135353904,1093,0.085,2.44615384615385,110,70,3554,699,0.368036015756894,0.35521611959701,109.892857142857
"J Montero","DH",226,806,73,204,31,1,28,104,48,172,0,3,0.253,0.295,0.398,0.6933449945084,321,0.145,0.27906976744186,3,0,854,177,0.295081967213115,0.398263027295285,28.7857142857143
"L Brinson","CF",357,1071,91,212,41,7,28,109,58,327,10,3,0.198,0.246,0.328,0.566880782428117,351,0.13,0.17737003058104,13,76.9230769230769,1129,200,0.239149689991143,0.327731092436975,38.25
"R Hoblitzell","1B",1319,4706,591,1310,194,88,27,593,407,256,173,26,0.278,0.341,0.374,0.71001382358361,1761,0.096,1.58984375,199,86.9346733668342,5113,1184,0.335810678662234,0.374203144921377,174.296296296296
"W Schulmerich","RF",429,1442,169,417,73,20,27,192,118,197,7,0,0.289,0.347,0.424,0.766665777588108,611,0.135,0.598984771573604,7,100,1560,361,0.342948717948718,0.42371705963939,53.4074074074074
"J Crawford","SS",527,1884,248,466,99,13,27,184,224,379,20,14,0.247,0.333,0.357,0.68401237626754,672,0.11,0.591029023746702,34,58.8235294117647,2108,432,0.327324478178368,0.356687898089172,69.7777777777778
"H Steinfeldt","3B",1318,5896,758,1576,284,90,27,762,471,32,194,0,0.267,0.33,0.36,0.68123690590837,2121,0.093,14.71875,194,100,6367,1520,0.321501492068478,0.359735413839891,218.37037037037
"M Tyson","2B",1017,2959,281,714,118,28,27,269,175,411,23,18,0.241,0.285,0.327,0.611138548894021,969,0.086,0.425790754257908,41,56.0975609756098,3134,550,0.283663050414805,0.327475498479216,109.592592592593
"D Davis","DH",403,1217,160,323,62,7,27,141,50,152,13,13,0.265,0.294,0.394,0.688808701252125,480,0.129,0.328947368421053,26,50,1267,301,0.294396211523283,0.394412489728841,45.0740740740741
"C Triplett","OF",471,1307,148,334,47,14,27,173,123,114,10,0,0.256,0.32,0.375,0.694484780712784,490,0.119,1.07894736842105,10,100,1430,321,0.31958041958042,0.374904361132364,48.4074074074074
"J Bauers","OF",328,977,121,208,45,3,27,110,129,297,15,10,0.213,0.307,0.348,0.652705721652251,340,0.135,0.434343434343434,25,60,1106,231,0.304701627486438,0.348004094165814,36.1851851851852
"C Travis","SS",1328,4914,665,1544,265,78,27,657,402,291,23,32,0.314,0.37,0.416,0.782426126669919,2046,0.102,1.38144329896907,55,41.8181818181818,5316,1322,0.366064710308503,0.416361416361416,182
"J Traber","1B",264,819,70,186,21,0,27,117,58,118,5,5,0.227,0.279,0.352,0.629869560314258,288,0.125,0.491525423728814,10,50,877,187,0.278221208665906,0.351648351648352,30.3333333333333
"R Grimes","1B",433,1537,269,505,101,25,27,263,204,133,21,17,0.329,0.413,0.48,0.886742750242253,737,0.151,1.53383458646617,38,55.2631578947368,1741,532,0.407237219988512,0.479505530253741,56.9259259259259
"J S?nchez","RF",174,572,67,126,24,5,27,74,51,184,1,1,0.22,0.29,0.421,0.70543782060636,241,0.201,0.277173913043478,2,50,623,141,0.284109149277689,0.421328671328671,21.1851851851852
"G Heredia","LF",591,1388,179,320,75,2,27,114,130,313,7,12,0.231,0.31,0.346,0.642264013395451,480,0.115,0.415335463258786,19,36.8421052631579,1518,293,0.296442687747036,0.345821325648415,51.4074074074074
"J Glasscock","SS",1736,7030,1163,2040,313,98,27,825,439,212,372,0,0.29,0.337,0.374,0.706016161252189,2630,0.084,2.07075471698113,372,100,7469,1988,0.331905208193868,0.374110953058321,260.37037037037
"D Solano","2B",687,2060,205,573,101,8,27,207,129,404,13,4,0.278,0.327,0.374,0.694966225656083,771,0.096,0.319306930693069,17,76.4705882352941,2189,412,0.320694380995889,0.374271844660194,76.2962962962963
"D Brain","3B",676,2543,254,641,97,52,27,303,134,0,73,0,0.252,0.292,0.363,0.652460312435596,923,0.111,Inf,73,100,2677,557,0.289503175196115,0.362957137239481,94.1851851851852
"S Stahoviak","1B",344,1019,135,261,70,3,27,119,116,277,13,8,0.256,0.335,0.41,0.742364674704837,418,0.154,0.418772563176895,21,61.9047619047619,1135,254,0.33215859030837,0.410206084396467,37.7407407407407
"F Torres","3B",365,1191,109,302,61,5,27,153,71,202,2,3,0.254,0.297,0.381,0.676754874447953,454,0.127,0.351485148514851,5,40,1262,262,0.295562599049128,0.381192275398824,44.1111111111111
"L Gardner","3B",1930,6688,867,1931,301,129,27,934,654,282,165,68,0.289,0.355,0.384,0.736503757303787,2571,0.095,2.31914893617021,233,70.8154506437768,7342,1801,0.352083900844457,0.38441985645933,247.703703703704
"C Cuthbert","3B",323,1077,100,269,53,2,27,119,75,234,3,1,0.25,0.3,0.378,0.676512689569793,407,0.128,0.320512820512821,4,75,1152,219,0.298611111111111,0.377901578458681,39.8888888888889
"K Harvey","1B",271,998,102,273,54,1,27,126,60,200,3,5,0.274,0.322,0.411,0.725566444798861,410,0.137,0.3,8,37.5,1058,228,0.314744801512287,0.410821643286573,36.962962962963
"E Young","CF",288,796,108,179,33,4,27,90,90,213,10,11,0.225,0.31,0.378,0.681752441666572,301,0.153,0.422535211267606,21,47.6190476190476,886,198,0.303611738148984,0.378140703517588,29.4814814814815
"U Washington","SS",907,2797,358,703,103,36,27,255,261,409,132,53,0.251,0.313,0.343,0.658106075999862,959,0.092,0.638141809290954,185,71.3513513513514,3058,613,0.315238718116416,0.342867357883447,103.592592592593
"D Lewis","CF",1354,4081,607,1021,137,37,27,342,403,514,247,107,0.25,0.323,0.322,0.639308463909141,1313,0.072,0.784046692607004,354,69.774011299435,4484,949,0.31757359500446,0.32173486890468,151.148148148148
"L Waner","CF",1993,7772,1201,2459,281,118,27,598,420,173,67,0,0.316,0.353,0.393,0.744775478580964,3057,0.077,2.42774566473988,67,100,8192,1799,0.3514404296875,0.393335048893464,287.851851851852
"R Moore","RF",751,2253,258,627,110,17,27,308,158,85,11,1,0.278,0.326,0.378,0.703753491128378,852,0.1,1.85882352941176,12,91.6666666666667,2411,566,0.3255910410618,0.378162450066578,83.4444444444444
"A Mora","LF",235,700,71,156,27,2,27,83,31,149,1,1,0.223,0.256,0.383,0.638671096345515,268,0.16,0.208053691275168,2,50,731,154,0.255813953488372,0.382857142857143,25.9259259259259
"R Smith","3B",1117,3907,477,1087,208,49,27,514,420,415,117,5,0.278,0.353,0.377,0.7255498166908,1474,0.099,1.01204819277108,122,95.9016393442623,4327,991,0.348278252831061,0.377271563859739,144.703703703704
"M Mitchell","RF",1125,4095,514,1138,130,104,27,514,368,216,202,7,0.278,0.34,0.38,0.717660963280502,1557,0.102,1.7037037037037,209,96.6507177033493,4463,1028,0.337441183060721,0.38021978021978,151.666666666667
"A Latham","3B",4,6822,1478,1833,245,85,27,563,588,240,739,0,0.269,0.334,0.341,0.668116132968237,2329,0.072,2.45,739,100,7410,2041,0.326720647773279,0.341395485194957,252.666666666667
"M Carp","1B",318,887,97,225,51,5,27,127,90,243,2,3,0.254,0.33,0.414,0.736169785564027,367,0.16,0.37037037037037,5,40,977,224,0.322415557830092,0.413754227733935,32.8518518518519
"P Tebeau","1B",1167,4618,671,1290,196,57,27,735,319,198,164,0,0.279,0.332,0.364,0.689916815013387,1681,0.085,1.61111111111111,164,100,4937,1406,0.325906420903383,0.364010394110004,171.037037037037
"C Barnhart","LF",814,2673,404,788,121,61,27,436,265,149,35,21,0.295,0.36,0.416,0.774419051213545,1112,0.121,1.77852348993289,56,62.5,2938,840,0.358407079646018,0.416011971567527,99
"H Clarke","2B",1272,4813,548,1230,150,23,27,304,365,362,151,58,0.256,0.308,0.313,0.621144316157388,1507,0.057,1.00828729281768,209,72.2488038277512,5178,852,0.308033989957513,0.313110326199875,178.259259259259
"S Sisti","2B",1016,2999,401,732,121,19,27,260,283,440,30,5,0.244,0.313,0.324,0.633370680740828,972,0.08,0.643181818181818,35,85.7142857142857,3282,661,0.309262644728824,0.324108036012004,111.074074074074
"T Boeckel","3B",777,2880,372,813,130,36,27,337,237,218,90,46,0.282,0.339,0.381,0.717417923216768,1096,0.099,1.08715596330275,136,66.1764705882353,3117,709,0.336862367661213,0.380555555555556,106.666666666667
"R LaCock","1B",715,1729,214,444,86,11,27,224,182,171,8,8,0.257,0.326,0.366,0.693684761353934,633,0.109,1.06432748538012,16,50,1911,438,0.327577184720042,0.366107576633892,64.037037037037
"E Owens","RF",806,2353,305,621,86,16,26,214,182,284,126,48,0.264,0.318,0.347,0.663981605588065,817,0.083,0.640845070422535,174,72.4137931034483,2535,519,0.316765285996055,0.34721631959201,90.5
"G Richards","LF",1026,3549,502,1028,127,63,26,255,356,436,247,89,0.29,0.357,0.383,0.737342181112495,1359,0.093,0.81651376146789,336,73.5119047619048,3905,757,0.354417413572343,0.382924767540152,136.5
"J Vitiello","1B",282,693,76,172,35,1,26,104,80,165,2,0,0.248,0.335,0.414,0.740144001463536,287,0.166,0.484848484848485,2,100,773,180,0.326002587322122,0.414141414141414,26.6538461538462
"T Perez","CF",603,1671,187,449,91,10,26,185,92,159,23,23,0.269,0.308,0.382,0.688670602208506,638,0.113,0.578616352201258,46,50,1763,372,0.306863301191151,0.381807301017355,64.2692307692308
"M Sullivan","LF",398,1618,280,441,56,32,26,220,162,168,99,0,0.273,0.341,0.395,0.733696059776948,639,0.122,0.964285714285714,99,100,1780,500,0.33876404494382,0.394932014833127,62.2307692307692
"W Jensen","LF",738,2720,392,774,114,37,26,235,69,100,20,0,0.285,0.307,0.382,0.684611815324911,1040,0.097,0.69,20,100,2789,627,0.30225887414844,0.382352941176471,104.615384615385
"H Jeffcoat","P",918,1963,249,487,95,18,26,188,114,289,49,7,0.248,0.291,0.355,0.643919001283004,696,0.107,0.394463667820069,56,87.5,2077,437,0.289359653346172,0.354559347936831,75.5
"T McCreery","RF",267,2951,464,855,99,76,26,387,308,73,116,0,0.29,0.359,0.401,0.758077857329945,1184,0.111,4.21917808219178,116,100,3259,851,0.356857931880945,0.401219925449,113.5
"M Jimenez","LF",429,1003,90,273,43,4,26,144,75,97,0,2,0.272,0.337,0.401,0.723617644284216,402,0.129,0.77319587628866,2,0,1078,234,0.322820037105751,0.400797607178465,38.5769230769231
"E Mayo","2B",834,3013,350,759,119,16,26,287,257,175,29,38,0.252,0.313,0.328,0.638615743602392,988,0.076,1.46857142857143,67,43.2835820895522,3270,637,0.310703363914373,0.327912379688019,115.884615384615
"G Hampson","SS",419,1158,166,272,44,17,26,90,98,341,52,13,0.235,0.296,0.37,0.664188750646293,428,0.135,0.287390029325513,65,80,1256,256,0.294585987261146,0.369602763385147,44.5384615384615
"J Heim","C",224,716,80,154,34,1,26,87,59,149,5,1,0.215,0.275,0.374,0.649140385655073,268,0.159,0.395973154362416,6,83.3333333333333,775,167,0.274838709677419,0.374301675977654,27.5384615384615
"T White","1B",257,760,76,179,48,3,26,103,87,208,1,2,0.236,0.315,0.409,0.723260113092649,311,0.173,0.418269230769231,3,33.3333333333333,847,179,0.31404958677686,0.409210526315789,29.2307692307692
"J Macias","3B",659,1646,201,422,77,17,26,173,93,243,43,21,0.256,0.298,0.371,0.667350127201217,611,0.115,0.382716049382716,64,67.1875,1739,374,0.296147211040828,0.371202916160389,63.3076923076923
"D Buckley","C",524,1833,213,449,72,14,26,216,98,188,25,0,0.245,0.291,0.342,0.625335108713801,627,0.097,0.521276595744681,25,100,1931,429,0.283272915587778,0.342062193126023,70.5
"D Hill","2B",756,2307,276,594,91,14,26,228,175,225,22,11,0.257,0.308,0.343,0.652700309152644,791,0.086,0.777777777777778,33,66.6666666666667,2482,504,0.30983078162772,0.342869527524924,88.7307692307692
"M Hershberger","RF",1150,3572,398,900,150,22,26,344,319,311,74,36,0.252,0.316,0.328,0.641394575531498,1172,0.076,1.02572347266881,110,67.2727272727273,3891,742,0.313287072731946,0.328107502799552,137.384615384615
"B Brown","LF",502,1277,183,313,38,12,26,130,94,238,110,34,0.245,0.295,0.355,0.651601269614974,453,0.11,0.394957983193277,144,76.3888888888889,1371,313,0.296863603209336,0.354737666405638,49.1153846153846
"R Tapia","LF",569,1732,234,479,91,15,26,188,104,343,53,15,0.277,0.318,0.391,0.708993091719623,678,0.114,0.303206997084548,68,77.9411764705882,1836,422,0.317538126361656,0.391454965357968,66.6153846153846
"H Groh","3B",1676,6074,918,1774,308,87,26,566,696,345,180,66,0.292,0.373,0.384,0.749105687656277,2334,0.092,2.01739130434783,246,73.1707317073171,6770,1484,0.364844903988183,0.384260783668094,233.615384615385
"P Werden","1B",693,2740,444,773,109,87,26,439,281,140,150,0,0.282,0.359,0.414,0.762759708802374,1134,0.132,2.00714285714286,150,100,3021,883,0.348891095663688,0.413868613138686,105.384615384615
"? Mercado","RF",278,859,120,202,43,5,26,95,59,182,27,7,0.235,0.289,0.388,0.671973795338857,333,0.153,0.324175824175824,34,79.4117647058823,918,215,0.284313725490196,0.387660069848661,33.0384615384615
"R Bresnahan","C",1439,4481,682,1252,218,71,26,530,714,99,212,3,0.279,0.386,0.377,0.755588766514762,1690,0.098,7.21212121212121,215,98.6046511627907,5195,1212,0.378440808469682,0.377147958045079,172.346153846154
"C Zimmer","C",149,4546,617,1225,222,76,26,625,390,323,151,0,0.269,0.339,0.369,0.696083738995081,1677,0.1,1.20743034055728,151,100,4936,1242,0.327188006482982,0.368895732512099,174.846153846154
"J Gonder","C",395,876,73,220,28,2,26,94,72,184,1,2,0.251,0.31,0.377,0.684729206404254,330,0.126,0.391304347826087,3,33.3333333333333,948,167,0.308016877637131,0.376712328767123,33.6923076923077
"G Sheets","1B",179,541,57,131,27,0,26,87,43,128,0,0,0.242,0.302,0.436,0.734174410655053,236,0.194,0.3359375,0,0,584,144,0.297945205479452,0.436229205175601,20.8076923076923
"V Picinich","C",1038,2877,298,743,166,26,26,298,314,382,31,9,0.258,0.334,0.361,0.692384200567572,1039,0.103,0.821989528795812,40,77.5,3191,596,0.331244124099029,0.361140076468544,110.653846153846
"M Batts","C",546,1605,163,432,95,11,26,219,143,163,6,4,0.269,0.329,0.391,0.719601574028529,627,0.122,0.877300613496933,10,60,1748,382,0.328947368421053,0.390654205607477,61.7307692307692
"D Cooley","LF",558,5364,847,1576,180,102,26,557,365,73,224,0,0.294,0.341,0.38,0.718742926375471,2038,0.086,5,224,100,5729,1404,0.338802583347879,0.379940343027591,206.307692307692
"J Ward","SS",1825,7647,1408,2104,231,96,26,867,420,326,540,0,0.275,0.314,0.341,0.653536099661218,2605,0.066,1.28834355828221,540,100,8067,2275,0.312879633073014,0.340656466588205,294.115384615385
"B Coluccio","RF",370,1095,141,241,38,15,26,114,128,203,33,21,0.22,0.305,0.353,0.655141746659349,387,0.133,0.630541871921182,54,61.1111111111111,1223,255,0.301717089125102,0.353424657534247,42.1153846153846
"J Morales","DH",733,1305,126,375,68,6,26,207,89,182,0,4,0.287,0.332,0.408,0.741284212030761,533,0.121,0.489010989010989,4,0,1394,333,0.332855093256815,0.408429118773946,50.1923076923077
"D Stewart","RF",195,527,75,112,21,0,26,73,82,167,3,3,0.213,0.327,0.4,0.718934514851547,211,0.187,0.491017964071856,6,50,609,148,0.318555008210181,0.400379506641366,20.2692307692308
"S Boros","3B",422,1255,141,308,50,7,26,149,181,174,11,6,0.245,0.344,0.359,0.699094984962656,450,0.114,1.04022988505747,17,64.7058823529412,1436,290,0.340529247910864,0.358565737051793,48.2692307692308
"I Boone","RF",356,1160,177,372,79,11,26,194,138,67,3,7,0.321,0.394,0.475,0.86791217257319,551,0.154,2.05970149253731,10,30,1298,371,0.392912172573189,0.475,44.6153846153846
"R Woods","CF",582,1247,162,290,34,12,26,130,175,171,27,18,0.233,0.326,0.342,0.668624107139836,426,0.109,1.0233918128655,45,60,1422,292,0.327004219409283,0.341619887730553,47.9615384615385
"J Dyck","3B",330,983,139,242,52,5,26,114,131,140,4,6,0.246,0.339,0.389,0.723435750669825,382,0.143,0.935714285714286,10,40,1114,253,0.334829443447038,0.388606307222787,37.8076923076923
"S Robertson","2B",597,1507,200,346,55,18,26,151,202,238,32,16,0.23,0.323,0.342,0.662393907425577,515,0.112,0.848739495798319,48,66.6666666666667,1709,351,0.320655354008192,0.341738553417386,57.9615384615385
"E Sogard","2B",815,2236,267,551,104,11,26,187,207,342,46,15,0.246,0.313,0.338,0.647930782484657,755,0.092,0.605263157894737,61,75.4098360655738,2443,454,0.310274252967663,0.337656529516995,86
"A Toro","2B",262,824,107,170,30,3,26,99,65,161,10,5,0.206,0.276,0.345,0.6090021514301,284,0.139,0.403726708074534,15,66.6666666666667,889,206,0.264341957255343,0.344660194174757,31.6923076923077
"F Duffy","SS",915,2665,248,619,104,14,26,240,171,342,49,30,0.232,0.279,0.311,0.589630772406238,829,0.079,0.5,79,62.0253164556962,2836,488,0.278561354019746,0.311069418386492,102.5
"W Morris","2B",440,1495,176,399,70,7,26,164,150,218,16,22,0.267,0.334,0.375,0.70898943794411,561,0.108,0.688073394495413,38,42.1052631578947,1645,340,0.333738601823708,0.375250836120401,57.5
"G Blanco","CF",1060,2929,394,746,118,39,26,235,363,661,122,40,0.255,0.338,0.348,0.6851189989741,1020,0.093,0.549167927382753,162,75.3086419753086,3292,629,0.336877278250304,0.348241720723796,112.653846153846
"B Bochy","C",358,802,75,192,37,2,26,93,67,177,1,2,0.239,0.298,0.388,0.685824277051904,311,0.149,0.378531073446328,3,33.3333333333333,869,168,0.298043728423475,0.387780548628429,30.8461538461538
"J Boccabella","C",551,1462,117,320,56,5,26,148,96,246,3,7,0.219,0.267,0.317,0.584382446891644,464,0.098,0.390243902439024,10,30,1558,265,0.267008985879332,0.317373461012312,56.2307692307692
"J Borchard","RF",301,716,89,147,23,2,26,77,74,222,5,5,0.205,0.284,0.352,0.631702142705608,252,0.147,0.333333333333333,10,50,790,166,0.279746835443038,0.35195530726257,27.5384615384615
"O Destrade","1B",237,765,80,184,25,3,26,106,87,184,1,2,0.241,0.319,0.383,0.701081653318604,293,0.142,0.472826086956522,3,33.3333333333333,852,186,0.318075117370892,0.383006535947712,29.4230769230769
"T Estrada","2B",257,737,112,190,29,2,26,101,47,150,29,6,0.258,0.318,0.408,0.710708401406696,301,0.15,0.313333333333333,35,82.8571428571429,784,213,0.302295918367347,0.408412483039349,28.3461538461538
"A Gimenez","2B",267,811,116,222,39,5,26,98,54,196,40,4,0.274,0.345,0.43,0.749408066826796,349,0.156,0.275510204081633,44,90.9090909090909,865,214,0.319075144508671,0.430332922318126,31.1923076923077
"K Lewis","LF",133,472,69,115,13,0,26,59,58,162,7,1,0.244,0.327,0.436,0.762855772305724,206,0.192,0.358024691358025,8,87.5,530,128,0.326415094339623,0.436440677966102,18.1538461538462
"R Quinlan","1B",458,1112,134,307,54,5,25,121,69,187,16,10,0.276,0.322,0.401,0.719453395793103,446,0.125,0.368983957219251,26,61.5384615384615,1181,255,0.318374259102456,0.401079136690647,44.48
"I Wingo","C",1328,4003,362,1039,147,81,25,455,264,285,87,25,0.26,0.307,0.355,0.660850155680638,1423,0.095,0.926315789473684,112,77.6785714285714,4267,817,0.305366768221233,0.355483387459405,160.12
"H Shanks","OF",1664,5699,604,1440,211,96,25,620,415,443,185,64,0.253,0.308,0.337,0.639952300109696,1918,0.084,0.936794582392777,249,74.2971887550201,6114,1224,0.303402028132156,0.33655027197754,227.96
"H Villanueva","C",191,473,53,109,21,2,25,72,40,98,1,0,0.23,0.293,0.442,0.732308808196201,209,0.212,0.408163265306122,1,100,513,125,0.290448343079922,0.441860465116279,18.92
"N Jones","1B",412,1381,146,369,60,12,25,209,71,102,4,2,0.267,0.304,0.382,0.685361946766726,528,0.115,0.696078431372549,6,66.6666666666667,1452,355,0.303030303030303,0.382331643736423,55.24
"J Guzman","1B",403,1007,108,249,61,4,25,136,97,248,18,5,0.247,0.316,0.39,0.703673920239483,393,0.143,0.391129032258065,23,78.2608695652174,1104,244,0.313405797101449,0.390268123138034,40.28
"J McCarthy","1B",542,1557,182,432,72,16,25,209,90,114,8,0,0.277,0.319,0.392,0.709361213767544,611,0.115,0.789473684210526,8,100,1647,391,0.316939890710383,0.392421323057161,62.28
"B Hunter","CF",1000,3347,500,882,146,28,25,241,243,581,260,61,0.264,0.313,0.346,0.659650724508623,1159,0.082,0.418244406196213,321,80.9968847352025,3590,741,0.313370473537604,0.346280250971019,133.88
"J Sandberg","3B",196,630,83,139,38,2,25,92,65,236,4,2,0.221,0.297,0.406,0.699874386205321,256,0.185,0.275423728813559,6,66.6666666666667,695,175,0.293525179856115,0.406349206349206,25.2
"G Hopkins","1B",514,1219,142,324,47,6,25,145,160,83,6,4,0.266,0.352,0.376,0.726696771744931,458,0.11,1.92771084337349,10,60,1379,287,0.35097897026831,0.37571780147662,48.76
"A Bohm","3B",314,1137,151,316,51,3,25,145,79,259,7,4,0.278,0.325,0.394,0.718854875480257,448,0.116,0.305019305019305,11,63.6363636363636,1216,296,0.324835526315789,0.394019349164468,45.48
"D Hocking","SS",954,2358,294,591,112,17,25,226,205,442,36,27,0.251,0.31,0.344,0.654933173427424,812,0.093,0.463800904977376,63,57.1428571428571,2563,520,0.310573546625049,0.344359626802375,94.32
"J Willard","C",346,783,82,195,29,1,25,114,83,161,1,1,0.249,0.32,0.384,0.705435067942036,301,0.135,0.515527950310559,2,50,866,196,0.321016166281755,0.384418901660281,31.32
"W Herzog","RF",634,1614,213,414,60,20,25,172,241,261,13,18,0.257,0.354,0.365,0.718031576802707,589,0.108,0.923371647509579,31,41.9354838709677,1855,385,0.353099730458221,0.364931846344486,64.56
"V Wilson","C",403,953,104,238,42,2,25,129,46,189,2,8,0.25,0.302,0.377,0.660989425942207,359,0.127,0.243386243386243,10,20,999,233,0.284284284284284,0.376705141657922,38.12
"C Martinez","1B",465,1485,145,383,63,6,25,161,74,209,10,10,0.258,0.293,0.359,0.652059184964894,533,0.101,0.354066985645933,20,50,1559,306,0.293136626042335,0.358922558922559,59.4
"F Hatfield","3B",722,2039,259,493,67,10,25,165,248,247,15,14,0.242,0.332,0.321,0.645241146999492,655,0.079,1.00404858299595,29,51.7241379310345,2287,424,0.324005247048535,0.321235899950956,81.56
"M Brouhard","LF",304,909,108,235,40,7,25,104,53,183,2,11,0.259,0.305,0.4,0.6998163433807,364,0.141,0.289617486338798,13,15.3846153846154,962,212,0.299376299376299,0.4004400440044,36.36
"B Neis","CF",680,1825,297,496,84,18,25,210,201,186,46,39,0.272,0.346,0.379,0.722657777657575,691,0.107,1.08064516129032,85,54.1176470588235,2026,507,0.344027640671273,0.378630136986301,73
"S Brodie","CF",193,5699,886,1727,191,89,25,900,420,148,289,0,0.303,0.365,0.381,0.731818351137831,2171,0.078,2.83783783783784,289,100,6119,1786,0.35087432587024,0.380944025267591,227.96
"G Cutshaw","2B",1515,5621,629,1487,195,89,25,653,300,242,271,68,0.265,0.305,0.344,0.646051923474055,1935,0.079,1.2396694214876,339,79.9410029498525,5921,1282,0.301807127174464,0.344244796299591,224.84
"T Sledge","LF",291,705,81,174,32,7,25,100,82,151,6,6,0.247,0.327,0.418,0.743725612118918,295,0.171,0.543046357615894,12,50,787,181,0.325285895806862,0.418439716312057,28.2
"L Sakata","2B",564,1289,163,296,46,4,25,109,97,158,30,17,0.23,0.286,0.33,0.613262739329458,425,0.1,0.613924050632911,47,63.8297872340426,1386,272,0.283549783549784,0.329712955779674,51.56
"B Nahorodny","C",308,844,74,203,41,3,25,109,56,118,1,4,0.241,0.29,0.385,0.672848867825171,325,0.144,0.474576271186441,5,20,900,183,0.287777777777778,0.385071090047393,33.76
"R Ur?as","3B",216,702,88,185,34,1,25,94,60,185,2,2,0.264,0.33,0.422,0.743174731363708,296,0.158,0.324324324324324,4,50,762,182,0.321522309711286,0.421652421652422,28.08
"F Baumholtz","RF",1019,3477,450,1010,165,51,25,272,258,258,30,20,0.29,0.342,0.389,0.728332253373575,1352,0.099,1,50,60,3735,722,0.339491298527443,0.388840954846132,139.08
"W Weiss","SS",1495,4686,623,1207,182,31,25,386,658,658,96,35,0.258,0.351,0.326,0.674640395904733,1526,0.068,1,131,73.2824427480916,5344,1009,0.348989520958084,0.32565087494665,187.44
"C Herrmann","C",370,887,108,182,34,7,25,103,94,272,10,1,0.205,0.282,0.344,0.625201259097601,305,0.139,0.345588235294118,11,90.9090909090909,981,211,0.281345565749235,0.343855693348365,35.48
"J Gibbs","C",537,1639,157,382,53,8,25,146,120,231,28,22,0.233,0.289,0.321,0.606316820563018,526,0.088,0.519480519480519,50,56,1759,303,0.285389425810119,0.320927394752898,65.56
"B Gates","2B",685,2329,268,616,119,11,25,279,225,349,18,13,0.264,0.327,0.357,0.686522257074583,832,0.093,0.644699140401146,31,58.0645161290323,2554,547,0.329287392325763,0.357234864748819,93.16
"J McEwing","2B",754,1767,217,443,89,10,25,158,113,352,33,20,0.251,0.302,0.355,0.650583390528483,627,0.104,0.321022727272727,53,62.2641509433962,1880,375,0.295744680851064,0.354838709677419,70.68
"J Bates","CF",1097,3913,565,1087,167,73,25,417,503,190,187,0,0.278,0.367,0.377,0.737002980588673,1475,0.099,2.64736842105263,187,100,4416,982,0.360054347826087,0.376948632762586,156.52
"C Motton","LF",316,567,85,121,20,1,25,89,86,116,5,7,0.213,0.319,0.384,0.701478186419483,218,0.171,0.741379310344828,12,41.6666666666667,653,174,0.316998468606432,0.384479717813051,22.68
"N Liriano","2B",823,2216,296,576,105,27,25,240,212,300,59,30,0.26,0.324,0.366,0.690070417928024,810,0.106,0.706666666666667,89,66.2921348314607,2428,536,0.324546952224053,0.365523465703971,88.64
"T Foli","SS",1696,6047,576,1515,241,20,25,501,265,399,81,55,0.251,0.283,0.309,0.591412159461489,1871,0.058,0.664160401002506,136,59.5588235294118,6312,1077,0.282002534854246,0.309409624607243,241.88
"J Moses","C",386,1072,89,269,48,8,25,109,63,184,1,4,0.251,0.295,0.381,0.673108028141232,408,0.13,0.342391304347826,5,20,1135,198,0.292511013215859,0.380597014925373,42.88
"C Wells","RF",277,688,92,158,31,4,25,81,57,201,6,4,0.23,0.299,0.395,0.683939441236148,272,0.165,0.283582089552239,10,60,745,173,0.288590604026846,0.395348837209302,27.52
"J Walton","OF",598,1573,241,423,77,8,25,132,138,280,58,29,0.269,0.333,0.376,0.703593627561536,591,0.107,0.492857142857143,87,66.6666666666667,1711,373,0.327878433664524,0.375715193897012,62.92
"B Holt","3B",753,2367,316,621,127,17,25,234,233,508,41,15,0.262,0.332,0.362,0.690523219914855,857,0.1,0.458661417322835,56,73.2142857142857,2600,550,0.328461538461538,0.362061681453316,94.68
"J Doyle","1B",417,6039,971,1806,315,64,25,967,437,132,516,0,0.299,0.351,0.385,0.73118770098539,2324,0.086,3.31060606060606,516,100,6476,1938,0.346355775169858,0.384831925815532,241.56
"J Walsh","3B",257,1571,178,447,84,14,25,212,101,197,45,0,0.285,0.332,0.404,0.731315804701848,634,0.119,0.512690355329949,45,100,1672,390,0.327751196172249,0.403564608529599,62.84
"M de la Hoz","3B",494,1114,116,280,42,5,25,115,56,130,2,3,0.251,0.29,0.365,0.652529576946094,407,0.114,0.430769230769231,5,40,1170,231,0.287179487179487,0.365350089766607,44.56
"G Decker","LF",701,2727,420,753,98,49,25,415,173,124,112,0,0.276,0.324,0.376,0.694814561915962,1024,0.1,1.39516129032258,112,100,2900,835,0.319310344827586,0.375504217088376,109.08
"B Kuehne","3B",1087,4284,536,996,145,115,25,404,137,260,150,0,0.232,0.258,0.338,0.593811874444417,1446,0.106,0.526923076923077,150,100,4421,940,0.256276860438815,0.337535014005602,171.36
"G Shuba","LF",355,814,106,211,45,4,24,125,120,122,5,5,0.259,0.358,0.413,0.767166134403822,336,0.154,0.983606557377049,10,50,934,231,0.354389721627409,0.412776412776413,33.9166666666667
"R Knorr","C",253,676,82,153,27,3,24,88,47,161,0,1,0.226,0.278,0.382,0.658281977624461,258,0.156,0.291925465838509,1,0,723,170,0.276625172890733,0.381656804733728,28.1666666666667
"P Castiglione","3B",545,1670,205,426,62,11,24,150,103,126,10,6,0.255,0.3,0.349,0.646867348213894,582,0.094,0.817460317460317,16,62.5,1773,355,0.298364354201918,0.348502994011976,69.5833333333333
"H King","C",322,683,67,146,26,3,24,82,104,158,1,0,0.214,0.325,0.366,0.683694218458442,250,0.152,0.658227848101266,1,100,787,149,0.317662007623888,0.366032210834553,28.4583333333333
"E Cartwright","1B",495,1902,348,562,100,44,24,333,202,128,144,0,0.295,0.368,0.432,0.795294526873853,822,0.137,1.578125,144,100,2104,681,0.363117870722433,0.43217665615142,79.25
"G Sutherland","2B",1031,3104,308,754,109,10,24,239,207,219,11,24,0.243,0.291,0.308,0.597912164855044,955,0.065,0.945205479452055,35,31.4285714285714,3311,547,0.290244639081848,0.307667525773196,129.333333333333
"E Waitkus","1B",1140,4254,528,1214,215,44,24,373,372,204,28,8,0.285,0.344,0.374,0.716375584861917,1589,0.089,1.82352941176471,36,77.7777777777778,4626,901,0.342844790315607,0.373530794546309,177.25
"R Wilson","C",602,1765,206,455,84,8,24,189,215,163,25,12,0.258,0.338,0.355,0.693624631584972,627,0.097,1.31901840490798,37,67.5675675675676,1980,395,0.338383838383838,0.355240793201133,73.5416666666667
"F Mej?a","C",306,877,104,211,51,5,24,100,45,202,1,1,0.241,0.289,0.392,0.669903560996,344,0.151,0.222772277227723,2,50,922,204,0.27765726681128,0.392246294184721,36.5416666666667
"S Ontiveros","3B",732,2193,230,600,111,10,24,224,309,290,5,6,0.274,0.365,0.366,0.72947442319742,803,0.092,1.06551724137931,11,45.4545454545455,2502,454,0.363309352517986,0.366165070679435,91.375
"W Johnson","P",937,2324,241,547,94,41,24,255,110,251,13,4,0.235,0.274,0.342,0.612008663837178,795,0.107,0.438247011952191,17,76.4705882352941,2434,496,0.269926047658176,0.342082616179002,96.8333333333333
"A Melhuse","C",311,735,76,172,40,1,24,98,57,193,1,2,0.234,0.29,0.389,0.678257060399918,286,0.155,0.295336787564767,3,33.3333333333333,792,174,0.289141414141414,0.389115646258503,30.625
"J Stripp","3B",1147,4211,575,1238,219,43,24,464,280,226,50,0,0.294,0.34,0.384,0.721528706110075,1615,0.09,1.23893805309735,50,100,4491,1039,0.338009352037408,0.383519354072667,175.458333333333
"B McCosky","CF",1170,4172,664,1301,214,71,24,397,497,261,58,31,0.312,0.386,0.414,0.799522697903206,1729,0.102,1.90421455938697,89,65.1685393258427,4669,1061,0.385093167701863,0.414429530201342,173.833333333333
"C Gimenez","C",391,927,118,202,43,1,24,89,115,261,5,3,0.218,0.307,0.344,0.648343468601374,319,0.126,0.440613026819923,8,62.5,1042,207,0.304222648752399,0.344120819848975,38.625
"C Febles","2B",506,1656,255,414,65,18,24,146,163,297,68,20,0.25,0.328,0.354,0.671675855768286,587,0.104,0.548821548821549,88,77.2727272727273,1819,401,0.317207256734469,0.354468599033816,69
"A Wilson","C",581,2056,237,536,96,22,24,226,292,289,50,0,0.261,0.357,0.364,0.716453774716789,748,0.103,1.01038062283737,50,100,2348,463,0.352640545144804,0.363813229571984,85.6666666666667
"S O'Brien","3B",378,1052,135,242,35,8,24,100,60,155,5,9,0.23,0.273,0.347,0.618540908717893,365,0.117,0.387096774193548,14,35.7142857142857,1112,235,0.27158273381295,0.346958174904943,43.8333333333333
"M Bailey","C",340,949,101,209,37,1,24,101,166,222,2,5,0.22,0.337,0.337,0.673519919480974,320,0.117,0.747747747747748,7,28.5714285714286,1115,202,0.336322869955157,0.337197049525817,39.5416666666667
"M Kelly","LF",327,684,111,165,45,6,22,86,54,187,30,11,0.241,0.3,0.421,0.717800599058622,288,0.18,0.288770053475936,41,73.1707317073171,738,197,0.296747967479675,0.421052631578947,31.0909090909091
"K Orie","3B",316,1015,117,253,64,6,22,116,94,163,5,3,0.249,0.32,0.389,0.702057061125498,395,0.14,0.576687116564417,8,62.5,1109,233,0.312894499549143,0.389162561576355,46.1363636363636
"K Plawecki","C",449,1268,119,298,63,3,22,137,119,278,2,2,0.235,0.313,0.341,0.642131532322444,433,0.106,0.428057553956835,4,50,1387,256,0.300648882480173,0.341482649842271,57.6363636363636
"E Kasko","SS",1077,3546,411,935,146,13,22,261,265,353,31,31,0.264,0.317,0.331,0.645673247048241,1173,0.067,0.75070821529745,62,50,3811,672,0.314877984780897,0.330795262267343,161.181818181818
"J Keenan","C",523,1873,254,452,61,36,22,208,177,111,41,0,0.241,0.314,0.348,0.654400010417616,651,0.107,1.59459459459459,41,100,2050,462,0.306829268292683,0.347570742124933,85.1363636363636
"J Rojas","3B",324,1133,161,288,64,4,22,118,138,293,37,10,0.254,0.334,0.376,0.71116209724293,426,0.122,0.47098976109215,47,78.7234042553192,1271,279,0.335169158143194,0.375992939099735,51.5
"E Wilson","2B",555,1406,155,343,73,5,22,141,89,169,14,19,0.244,0.288,0.35,0.638892086947007,492,0.106,0.526627218934911,33,42.4242424242424,1495,296,0.288963210702341,0.349928876244666,63.9090909090909
"J Johnston","3B",1379,5070,754,1493,185,75,22,410,391,246,169,83,0.294,0.347,0.374,0.718561779474827,1894,0.08,1.58943089430894,252,67.0634920634921,5461,1164,0.344991759750961,0.373570019723866,230.454545454545
"F Schwindel","1B",145,528,67,142,31,1,22,79,35,101,2,1,0.269,0.314,0.456,0.770826605307067,241,0.187,0.346534653465347,3,66.6666666666667,563,146,0.314387211367673,0.456439393939394,24
"T Hutton","1B",952,1655,196,410,63,7,22,186,234,140,15,21,0.248,0.339,0.334,0.675060095096592,553,0.086,1.67142857142857,36,41.6666666666667,1889,382,0.340921122286924,0.334138972809668,75.2272727272727
"A LaRoche","3B",404,1184,133,267,53,6,22,113,121,208,8,3,0.226,0.304,0.336,0.633466656311484,398,0.11,0.581730769230769,11,72.7272727272727,1305,246,0.297318007662835,0.336148648648649,53.8181818181818
"M Stock","3B",1628,6249,839,1806,270,58,22,696,455,321,155,75,0.289,0.339,0.361,0.698599150565761,2258,0.072,1.41744548286604,230,67.3913043478261,6704,1535,0.337261336515513,0.361337814050248,284.045454545455
"B Howerton","CF",247,650,95,178,39,12,22,106,92,125,1,1,0.274,0.364,0.472,0.836189093924943,307,0.198,0.736,2,50,742,201,0.363881401617251,0.472307692307692,29.5454545454545
"G Bennett","C",587,1690,141,408,74,3,22,192,139,270,6,5,0.241,0.302,0.328,0.626881181232025,554,0.087,0.514814814814815,11,54.5454545454545,1829,333,0.299070530344451,0.327810650887574,76.8181818181818
"J Pe?a","SS",140,536,75,136,21,2,22,64,23,140,12,3,0.254,0.292,0.424,0.707943956425386,227,0.17,0.164285714285714,15,80,559,139,0.284436493738819,0.423507462686567,24.3636363636364
"N Mathews","CF",306,978,93,218,39,14,22,98,88,248,8,12,0.223,0.288,0.359,0.645950114527101,351,0.136,0.354838709677419,20,40,1066,191,0.287054409005629,0.358895705521472,44.4545454545455
"J Buchek","2B",421,1177,96,259,35,11,22,108,75,312,5,11,0.22,0.269,0.325,0.591327113661472,382,0.105,0.240384615384615,16,31.25,1252,204,0.266773162939297,0.324553950722175,53.5
"B Brubaker","3B",479,1564,208,413,85,10,22,225,151,239,13,0,0.264,0.333,0.373,0.702264508287787,584,0.109,0.631799163179916,13,100,1715,433,0.328862973760933,0.373401534526854,71.0909090909091
"B Brown","3B",548,1619,233,452,62,14,22,237,214,88,9,10,0.279,0.367,0.376,0.738879245942971,608,0.097,2.43181818181818,19,47.3684210526316,1833,470,0.363338788870704,0.375540457072267,73.5909090909091
"J Hiatt","C",483,1142,110,287,51,5,22,154,224,295,0,1,0.251,0.374,0.363,0.736606810891478,414,0.112,0.759322033898305,1,0,1366,264,0.374084919472914,0.362521891418564,51.9090909090909
"C Hemphill","CF",1179,4541,580,1230,117,68,22,421,435,0,207,0,0.271,0.337,0.341,0.675720401330925,1549,0.07,Inf,207,100,4976,1001,0.334606109324759,0.341114292006166,206.409090909091
"R Nichols","CF",540,1160,156,308,63,8,22,131,99,149,27,21,0.266,0.326,0.391,0.713789679822519,453,0.125,0.664429530201342,48,56.25,1259,287,0.323272438443209,0.39051724137931,52.7272727272727
"M Newfield","LF",355,957,98,238,53,1,22,132,69,162,1,4,0.249,0.303,0.375,0.67435088941441,359,0.126,0.425925925925926,5,20,1026,230,0.299220272904483,0.375130616509927,43.5
"G Beckert","2B",1320,5208,685,1473,196,31,22,360,260,243,49,25,0.283,0.318,0.345,0.661980976877619,1797,0.062,1.06995884773663,74,66.2162162162162,5468,1045,0.31693489392831,0.345046082949309,236.727272727273
"E Ainsmith","C",1082,3048,299,707,108,54,22,317,263,315,86,16,0.232,0.296,0.324,0.617437916719184,989,0.092,0.834920634920635,102,84.3137254901961,3311,616,0.292962851102386,0.324475065616798,138.545454545455
"V Stallcup","SS",587,2059,171,497,99,13,22,214,51,181,9,4,0.241,0.26,0.334,0.593858427571476,688,0.093,0.281767955801105,13,69.2307692307692,2110,385,0.259715639810427,0.334142787761049,93.5909090909091
"D Dallessandro","LF",747,1945,242,520,110,23,22,303,310,150,16,1,0.267,0.369,0.381,0.749561956007501,742,0.114,2.06666666666667,17,94.1176470588235,2255,545,0.368070953436807,0.381491002570694,88.4090909090909
"A Mangual","CF",450,1241,122,304,44,8,22,125,59,187,5,8,0.245,0.279,0.346,0.625725531519246,430,0.101,0.315508021390374,13,38.4615384615385,1300,247,0.279230769230769,0.346494762288477,56.4090909090909
"N Santovenia","C",297,884,77,206,42,4,22,116,59,165,4,7,0.233,0.281,0.364,0.645271421236738,322,0.131,0.357575757575758,11,36.3636363636364,943,193,0.28101802757158,0.364253393665158,40.1818181818182
"B Sarni","C",390,1182,107,311,50,11,22,151,89,135,6,5,0.263,0.313,0.38,0.694577460757414,449,0.117,0.659259259259259,11,54.5454545454545,1271,258,0.3147128245476,0.379864636209814,53.7272727272727
"J Powell","LF",688,2540,353,689,116,26,22,327,173,219,65,35,0.271,0.32,0.363,0.681115277564134,923,0.092,0.789954337899543,100,65,2713,680,0.317729450792481,0.363385826771654,115.454545454545
"B Haas","1B",721,2440,263,644,93,32,22,263,204,188,51,0,0.264,0.323,0.355,0.67605404131842,867,0.091,1.08510638297872,51,100,2644,526,0.320726172465961,0.355327868852459,110.909090909091
"M Cummings","RF",460,1113,136,286,60,8,22,124,94,200,9,6,0.257,0.318,0.385,0.699376428753803,428,0.128,0.47,15,60,1207,260,0.314830157415079,0.384546271338724,50.5909090909091
"R Freel","CF",594,1983,306,532,100,17,22,122,222,350,143,48,0.268,0.354,0.369,0.711087783575357,732,0.101,0.634285714285714,191,74.869109947644,2205,428,0.341950113378685,0.369137670196672,90.1363636363636
"E Tipton","LF",501,1626,212,439,80,19,22,151,223,127,20,0,0.27,0.36,0.383,0.741180199795508,623,0.113,1.75590551181102,20,100,1849,363,0.358031368307193,0.383148831488315,73.9090909090909
"A Pilarcik","RF",668,1614,205,413,66,7,22,143,185,150,41,18,0.256,0.334,0.346,0.678751378467867,559,0.09,1.23333333333333,59,69.4915254237288,1799,348,0.332406892718177,0.34634448574969,73.3636363636364
"L Lopez","SS",721,1620,171,390,85,7,22,151,100,343,10,12,0.241,0.293,0.343,0.627476313522825,555,0.102,0.291545189504373,22,45.4545454545455,1720,322,0.284883720930233,0.342592592592593,73.6363636363636
"B Geren","C",307,765,62,178,21,1,22,76,49,179,0,1,0.233,0.283,0.349,0.627889386712916,267,0.116,0.273743016759777,1,0,814,138,0.278869778869779,0.349019607843137,34.7727272727273
"H Mueller","CF",693,2118,296,597,87,37,22,272,168,147,37,18,0.282,0.342,0.389,0.723691939357439,824,0.107,1.14285714285714,55,67.2727272727273,2286,568,0.334645669291339,0.3890462700661,96.2727272727273
"M Arnovich","LF",590,2013,234,577,104,12,22,261,185,139,17,0,0.287,0.35,0.383,0.729689231098858,771,0.096,1.33093525179856,17,100,2198,495,0.346678798908098,0.38301043219076,91.5
"R Goins","2B",556,1545,154,353,71,12,22,158,108,371,6,6,0.228,0.278,0.333,0.611572956495692,514,0.105,0.291105121293801,12,50,1653,312,0.278886872353297,0.332686084142395,70.2272727272727
"L Mouton","RF",328,805,96,225,43,2,22,116,71,209,9,4,0.28,0.339,0.42,0.757775319776511,338,0.14,0.339712918660287,13,69.2307692307692,876,212,0.337899543378995,0.419875776397516,36.5909090909091
"B Anderson","CF",355,799,108,181,47,1,22,80,65,208,13,14,0.227,0.29,0.37,0.655185301070783,296,0.143,0.3125,27,48.1481481481481,864,188,0.284722222222222,0.370463078848561,36.3181818181818
"R Freed","RF",344,717,49,176,27,2,22,109,95,166,1,4,0.245,0.334,0.381,0.714496980439846,273,0.136,0.572289156626506,5,20,812,158,0.333743842364532,0.380753138075314,32.5909090909091
"M Franco","1B",661,977,110,261,43,6,22,117,124,158,2,2,0.267,0.349,0.391,0.740674942385121,382,0.124,0.784810126582278,4,50,1101,227,0.349682107175295,0.390992835209826,44.4090909090909
"W Conroy","3B",1379,5061,605,1257,176,82,22,452,345,0,262,0,0.248,0.301,0.329,0.624928590398032,1663,0.081,Inf,262,100,5406,1057,0.296337402885683,0.328591187512349,230.045454545455
"J Lewis","RF",266,771,97,175,24,6,22,74,95,194,8,9,0.227,0.313,0.359,0.671051961550789,277,0.132,0.489690721649485,17,47.0588235294118,866,171,0.311778290993072,0.359273670557717,35.0454545454545
"J LeMaster","SS",1039,3191,320,709,109,19,22,229,241,564,94,51,0.222,0.277,0.289,0.565744163910883,922,0.067,0.427304964539007,145,64.8275862068965,3432,549,0.276806526806527,0.288937637104356,145.045454545455
"S Collins","RF",1803,6390,747,1687,310,133,22,709,331,405,225,83,0.264,0.306,0.364,0.664728681899794,2329,0.1,0.817283950617284,308,73.0519480519481,6721,1456,0.300252938550811,0.364475743348983,290.454545454545
"G Rosen","CF",551,1916,310,557,71,34,22,197,218,166,12,0,0.291,0.364,0.398,0.760871309135519,762,0.107,1.31325301204819,12,100,2134,507,0.363167760074977,0.397703549060543,87.0909090909091
"F Vaughn","C",915,3454,474,946,147,53,21,525,151,128,92,0,0.274,0.307,0.365,0.669673063934396,1262,0.091,1.1796875,92,100,3605,999,0.304299583911234,0.365373480023162,164.47619047619
"Q McCracken","CF",999,2462,359,675,118,32,21,244,229,445,89,44,0.274,0.336,0.374,0.709614531816347,920,0.1,0.514606741573034,133,66.9172932330827,2691,603,0.335934596804162,0.373679935012185,117.238095238095
"J Stallings","C",365,1107,108,270,48,1,21,128,115,266,1,1,0.244,0.319,0.346,0.661037409610321,383,0.102,0.432330827067669,2,50,1222,236,0.31505728314239,0.345980126467931,52.7142857142857
"J Dyson","CF",992,2513,387,612,83,38,21,185,242,478,266,49,0.244,0.314,0.332,0.641856105059498,834,0.088,0.506276150627615,315,84.4444444444444,2755,572,0.309981851179673,0.331874253879825,119.666666666667
"A Amarista","SS",702,1750,171,404,67,16,21,169,109,295,39,10,0.231,0.275,0.323,0.599383385844924,566,0.092,0.369491525423729,49,79.5918367346939,1859,340,0.275954814416353,0.323428571428571,83.3333333333333
"H S?nchez","C",347,783,60,186,38,0,21,120,34,207,0,1,0.238,0.273,0.367,0.635816798523083,287,0.129,0.164251207729469,1,0,817,180,0.269277845777234,0.366538952745849,37.2857142857143
"J Wohlford","OF",1220,3049,349,793,125,33,21,305,241,376,89,68,0.26,0.313,0.343,0.657676990113855,1047,0.083,0.640957446808511,157,56.687898089172,3290,654,0.314285714285714,0.34339127582814,145.190476190476
"D Schofield","SS",1322,3083,394,699,113,20,21,211,390,526,12,29,0.227,0.317,0.297,0.610350604202252,915,0.07,0.741444866920152,41,29.2682926829268,3473,605,0.313561762165275,0.296788842036977,146.809523809524
"J Lobat?n","C",419,1145,110,244,47,4,21,107,123,298,0,2,0.213,0.291,0.316,0.605589381896326,362,0.103,0.412751677852349,2,0,1268,217,0.289432176656151,0.316157205240175,54.5238095238095
"K Manwaring","C",1008,2982,248,733,111,20,21,278,243,505,10,19,0.246,0.311,0.318,0.620207758176969,947,0.072,0.481188118811881,29,34.4827586206897,3225,526,0.302635658914729,0.31757209926224,142
"J Harshman","P",258,424,46,76,7,0,21,65,72,119,0,0,0.179,0.294,0.344,0.642726719415703,146,0.165,0.605042016806723,0,0,496,111,0.298387096774194,0.344339622641509,20.1904761904762
"J White","CF",646,1196,155,303,50,9,21,109,148,174,57,28,0.253,0.337,0.363,0.698441730371078,434,0.11,0.850574712643678,85,67.0588235294118,1344,264,0.335565476190476,0.362876254180602,56.9523809523809
"B LaHair","1B",195,535,66,139,26,1,21,56,61,182,4,3,0.26,0.334,0.43,0.765477011854732,230,0.17,0.335164835164835,7,57.1428571428571,596,122,0.335570469798658,0.429906542056075,25.4761904761905
"B Smith","3B",258,826,88,192,29,4,21,107,70,268,11,9,0.232,0.297,0.354,0.645921610169492,292,0.122,0.261194029850746,20,55,896,195,0.292410714285714,0.353510895883777,39.3333333333333
"D Nen","1B",367,826,70,185,23,3,21,107,77,152,1,5,0.224,0.288,0.335,0.625495054150947,277,0.111,0.506578947368421,6,16.6666666666667,903,177,0.290143964562569,0.335351089588378,39.3333333333333
"T Satriano","C",674,1623,130,365,53,5,21,157,214,225,7,8,0.225,0.316,0.303,0.61771399228094,491,0.078,0.951111111111111,15,46.6666666666667,1837,287,0.31518780620577,0.302526186075169,77.2857142857143
"B Hallman","2B",264,6012,937,1634,234,81,21,769,425,283,200,0,0.272,0.325,0.348,0.668006563642432,2093,0.076,1.5017667844523,200,100,6437,1706,0.319869504427528,0.348137059214904,286.285714285714
"J Narron","C",392,840,64,177,23,2,21,96,67,127,0,0,0.211,0.27,0.318,0.586875885966294,267,0.107,0.52755905511811,0,0,907,160,0.269018743109151,0.317857142857143,40
"J Stafford","CF",568,2128,341,583,60,19,21,290,164,96,117,0,0.274,0.331,0.35,0.675540290516868,744,0.076,1.70833333333333,117,100,2292,631,0.325916230366492,0.349624060150376,101.333333333333
"B Pocoroba","C",596,1457,132,374,71,2,21,172,182,109,6,8,0.257,0.339,0.351,0.690638239246439,512,0.094,1.6697247706422,14,42.8571428571429,1639,304,0.339231238560098,0.351407000686342,69.3809523809524
"E Adrianza","2B",612,1358,183,325,75,9,21,149,126,297,19,8,0.239,0.309,0.354,0.658105704837858,481,0.115,0.424242424242424,27,70.3703703703704,1484,332,0.303908355795148,0.35419734904271,64.6666666666667
"F Santangelo","CF",665,1691,258,415,87,14,21,162,240,319,37,18,0.245,0.364,0.351,0.689882556722601,593,0.106,0.752351097178683,55,67.2727272727273,1931,420,0.339202485758674,0.350680070963927,80.5238095238095
"G Pinkney","3B",1163,4610,874,1212,170,56,21,539,526,135,296,0,0.263,0.345,0.338,0.676139673336442,1557,0.075,3.8962962962963,296,100,5136,1413,0.338395638629284,0.337744034707158,219.52380952381
"D Berg","SS",582,1600,190,430,91,6,21,163,133,308,8,7,0.269,0.328,0.373,0.697370167339873,596,0.104,0.431818181818182,15,53.3333333333333,1733,353,0.324870167339873,0.3725,76.1904761904762
"J Crooks","2B",794,2780,536,668,74,44,21,313,610,195,220,0,0.24,0.385,0.321,0.698214172025212,893,0.081,3.12820512820513,220,100,3390,849,0.376991150442478,0.321223021582734,132.380952380952
"E Scott","SS",1655,5837,553,1455,208,58,20,551,243,282,69,60,0.249,0.281,0.315,0.594335421494459,1839,0.066,0.861702127659574,129,53.4883720930233,6080,1104,0.279276315789474,0.315059105704985,291.85
"C Corpor?n","C",232,701,63,153,25,1,20,78,44,205,0,1,0.218,0.28,0.342,0.606797575850415,240,0.124,0.214634146341463,1,0,745,141,0.264429530201342,0.342368045649073,35.05
"B North","CF",1169,3900,640,1016,120,31,20,230,627,665,395,162,0.261,0.365,0.323,0.685497612614909,1258,0.062,0.942857142857143,557,70.9156193895871,4527,870,0.362933510050806,0.322564102564103,195
"L Norris","SS",270,962,109,252,51,7,20,112,60,132,7,0,0.262,0.307,0.392,0.697175649230444,377,0.13,0.454545454545455,7,100,1022,221,0.305283757338552,0.391891891891892,48.1
"C Hiller","2B",704,2121,253,516,76,9,20,152,157,187,14,14,0.243,0.299,0.316,0.611323323477463,670,0.073,0.839572192513369,28,50,2278,405,0.295434591747147,0.315888731730316,106.05
"B Hinchman","RF",908,3043,364,793,128,69,20,369,298,174,85,17,0.261,0.336,0.368,0.694278152034743,1119,0.107,1.71264367816092,102,83.3333333333333,3341,733,0.326548937443879,0.367729214590864,152.15
"B Herzog","2B",1495,5284,705,1370,191,75,20,445,427,307,312,53,0.259,0.329,0.335,0.649818682646382,1771,0.076,1.39087947882736,365,85.4794520547945,5711,1150,0.314655927158116,0.335162755488266,264.2
"T Buck","RF",253,810,99,197,52,7,20,95,78,186,8,3,0.243,0.316,0.399,0.70845011678345,323,0.156,0.419354838709677,11,72.7272727272727,888,194,0.309684684684685,0.398765432098765,40.5
"M Belanger","SS",2016,5784,676,1316,175,33,20,389,576,839,167,75,0.228,0.3,0.28,0.577048592082257,1617,0.052,0.686531585220501,242,69.0082644628099,6360,1065,0.29748427672956,0.279564315352697,289.2
"F Healy","C",470,1326,145,332,60,6,20,141,154,242,30,17,0.25,0.329,0.35,0.678302963597081,464,0.1,0.636363636363636,47,63.8297872340426,1480,286,0.328378378378378,0.349924585218703,66.3
"B Aven","LF",259,609,85,166,33,2,20,103,57,135,6,4,0.273,0.343,0.432,0.766690335655853,263,0.159,0.422222222222222,10,60,666,188,0.334834834834835,0.431855500821018,30.45
"B Dixon","3B",202,536,56,122,28,4,20,65,28,188,5,1,0.228,0.269,0.407,0.672673864718958,218,0.179,0.148936170212766,6,83.3333333333333,564,121,0.265957446808511,0.406716417910448,26.8
"D Trout","P",535,961,99,205,28,7,20,110,59,226,7,2,0.213,0.26,0.319,0.578282426394075,307,0.106,0.261061946902655,9,77.7777777777778,1020,209,0.258823529411765,0.31945889698231,48.05
"J Hayes","2B",1093,4040,494,1069,196,33,20,493,309,241,34,31,0.265,0.318,0.344,0.661161379991759,1391,0.079,1.28215767634855,65,52.3076923076923,4349,987,0.316854449298689,0.344306930693069,202
"I Brown","2B",280,536,85,137,15,4,20,65,90,130,3,7,0.256,0.364,0.41,0.773067569500739,220,0.154,0.692307692307692,10,30,626,150,0.362619808306709,0.41044776119403,26.8
"B Scheffing","C",517,1357,105,357,53,9,20,187,103,127,6,0,0.263,0.316,0.36,0.674685294919292,488,0.097,0.811023622047244,6,100,1460,292,0.315068493150685,0.359616801768607,67.85
"C Pride","LF",421,796,132,199,39,12,20,82,85,211,29,14,0.25,0.327,0.405,0.726883566527302,322,0.155,0.402843601895735,43,67.4418604651163,881,214,0.322360953461975,0.404522613065327,39.8
"S Scarsone","2B",350,830,103,198,44,4,20,86,70,266,7,8,0.239,0.302,0.373,0.671271753681392,310,0.134,0.263157894736842,15,46.6666666666667,900,189,0.297777777777778,0.373493975903614,41.5
"F Manrique","2B",498,1337,151,340,59,11,20,151,65,239,18,14,0.254,0.292,0.36,0.648633696706383,481,0.106,0.271966527196653,32,56.25,1402,302,0.288873038516405,0.359760658189978,66.85
"D Nelson","2B",813,2578,340,630,77,19,20,211,220,392,187,73,0.244,0.305,0.312,0.616045984303318,805,0.068,0.561224489795918,260,71.9230769230769,2798,551,0.303788420300214,0.312257564003103,128.9
"J Fox","LF",193,489,55,116,28,2,20,73,27,106,0,0,0.237,0.288,0.425,0.70248965615637,208,0.188,0.254716981132075,0,0,516,128,0.277131782945736,0.425357873210634,24.45
"T Gregg","1B",446,880,86,214,41,2,20,88,71,158,14,12,0.243,0.301,0.363,0.662184542586751,319,0.12,0.449367088607595,26,53.8461538461538,951,174,0.299684542586751,0.3625,44
"J Grace","RF",484,1561,225,442,76,18,20,172,179,135,9,17,0.283,0.362,0.393,0.750234155824074,614,0.11,1.32592592592593,26,34.6153846153846,1740,397,0.356896551724138,0.393337604099936,78.05
"M Goliat","2B",249,825,87,186,21,10,20,99,83,127,3,1,0.225,0.3,0.348,0.644134294486717,287,0.123,0.653543307086614,4,75,908,186,0.29625550660793,0.347878787878788,41.25
"J Ginsberg","C",695,1716,168,414,59,8,20,182,226,135,7,5,0.241,0.332,0.32,0.649487227499586,549,0.079,1.67407407407407,12,58.3333333333333,1942,350,0.329557157569516,0.31993006993007,85.8
"P Gharrity","C",677,1961,238,513,92,26,20,249,188,231,32,13,0.262,0.331,0.366,0.691828012459811,717,0.104,0.813852813852814,45,71.1111111111111,2149,487,0.326198231735691,0.36562978072412,98.05
"S Lombardozzi","2B",446,1264,153,294,61,12,20,107,131,206,13,9,0.233,0.307,0.347,0.651969624790164,439,0.114,0.635922330097087,22,59.0909090909091,1395,260,0.304659498207885,0.347310126582278,63.2
"O Timmons","LF",186,405,62,95,20,1,20,60,33,82,4,1,0.235,0.293,0.437,0.729274479959412,177,0.202,0.402439024390244,5,80,438,122,0.292237442922374,0.437037037037037,20.25
"R Washington","SS",564,1586,190,414,65,22,20,146,65,266,28,18,0.261,0.292,0.368,0.657718620607481,583,0.107,0.244360902255639,46,60.8695652173913,1651,336,0.290127195639007,0.367591424968474,79.3
"D Frobel","RF",268,542,70,109,21,4,20,58,55,155,13,10,0.201,0.276,0.365,0.640020520808223,198,0.164,0.354838709677419,23,56.5217391304348,597,128,0.274706867671692,0.365313653136531,27.1
"J Trevino","C",273,830,91,204,43,1,20,98,33,164,3,2,0.246,0.275,0.372,0.646912563347248,309,0.126,0.201219512195122,5,60,863,189,0.274623406720742,0.372289156626506,41.5
"J Fogarty","RF",751,2880,508,709,110,55,20,320,351,327,325,0,0.246,0.335,0.343,0.671474582172702,989,0.097,1.07339449541284,325,100,3231,828,0.328071804394924,0.343402777777778,144
"G Hern?ndez","CF",394,988,122,227,44,8,20,81,79,253,29,12,0.23,0.292,0.351,0.63799995446767,347,0.121,0.312252964426877,41,70.7317073170732,1067,203,0.286785379568885,0.351214574898785,49.4
"T Bosley","LF",783,1580,183,430,50,12,20,158,143,274,47,24,0.272,0.33,0.357,0.689521514579369,564,0.085,0.521897810218978,71,66.1971830985916,1723,341,0.332559489262914,0.356962025316456,79
"R Coleman","RF",559,1729,208,446,74,33,20,199,148,158,19,20,0.258,0.318,0.374,0.690088813690305,646,0.116,0.936708860759494,39,48.7179487179487,1877,407,0.316462440063932,0.373626373626374,86.45
"J Rickard","RF",347,904,103,222,47,3,20,71,61,223,20,6,0.246,0.3,0.371,0.663839469943601,335,0.125,0.273542600896861,26,76.9230769230769,965,174,0.293264248704663,0.370575221238938,45.2
"C Fanzone","3B",237,588,66,132,27,0,20,94,74,119,3,6,0.224,0.313,0.372,0.683627227325976,219,0.148,0.621848739495798,9,33.3333333333333,662,160,0.311178247734139,0.372448979591837,29.4
"W Clarke","C",439,3346,394,858,110,32,20,429,176,58,54,0,0.256,0.31,0.326,0.619943024004524,1092,0.07,3.03448275862069,54,100,3522,823,0.293583191368541,0.326359832635983,167.3
"E Pellagrini","SS",563,1423,167,321,42,13,20,133,128,201,13,7,0.226,0.295,0.316,0.605021220412737,449,0.09,0.63681592039801,20,65,1551,300,0.289490651192779,0.315530569219958,71.15
"G Robertson","3B",656,2200,311,615,100,23,20,249,205,79,29,22,0.28,0.344,0.373,0.714138159138159,821,0.093,2.59493670886076,51,56.8627450980392,2405,560,0.340956340956341,0.373181818181818,110
"B Barnes","CF",484,1172,133,284,56,9,20,102,67,358,22,20,0.242,0.29,0.357,0.639948268310621,418,0.115,0.187150837988827,42,52.3809523809524,1239,235,0.283292978208232,0.356655290102389,58.6
"K Roberson","RF",165,309,44,61,10,1,20,51,27,93,0,2,0.197,0.275,0.43,0.692325473878872,133,0.233,0.290322580645161,2,0,336,95,0.261904761904762,0.43042071197411,15.45
"M Pappas","P",527,1073,72,132,13,3,20,67,36,510,1,0,0.123,0.157,0.197,0.348132747653907,211,0.074,0.0705882352941176,1,100,1109,139,0.151487826871055,0.196644920782852,53.65
"C Childs","2B",63,5618,1214,1720,205,100,20,743,991,117,269,0,0.306,0.416,0.389,0.799126658842132,2185,0.083,8.47008547008547,269,100,6609,1957,0.410198214555909,0.388928444286223,280.9
"T Shinjo","CF",303,876,98,215,41,4,20,100,55,128,9,6,0.245,0.299,0.37,0.659873754837191,324,0.125,0.4296875,15,60,931,198,0.290010741138561,0.36986301369863,43.8
"B Ripken","2B",912,2729,287,674,121,6,20,229,174,332,25,16,0.247,0.294,0.318,0.609810399446523,867,0.071,0.524096385542169,41,60.9756097560976,2903,516,0.292111608680675,0.317698790765848,136.45
"F Chance","1B",1117,4297,797,1273,200,79,20,596,554,29,401,0,0.296,0.394,0.394,0.770153746648976,1691,0.098,19.1034482758621,401,100,4851,1393,0.376623376623377,0.393530370025599,214.85
"L Blanks","SS",629,1766,203,446,57,14,20,172,132,178,9,7,0.253,0.302,0.335,0.63918567198947,591,0.082,0.741573033707865,16,56.25,1898,375,0.304531085353003,0.334654586636467,88.3
"F Parent","SS",1328,4984,633,1306,180,74,20,471,333,0,184,0,0.262,0.315,0.34,0.648144176089837,1694,0.078,Inf,184,100,5317,1104,0.308256535640399,0.339887640449438,249.2
"E Rios","3B",113,262,39,57,9,1,20,43,26,94,0,1,0.218,0.299,0.489,0.776744062765055,128,0.271,0.276595744680851,1,0,288,82,0.288194444444444,0.488549618320611,13.1
"F Chance","1B",1117,4297,797,1273,200,79,20,596,554,29,401,0,0.296,0.394,0.394,0.770153746648976,1691,0.098,19.1034482758621,401,100,4851,1393,0.376623376623377,0.393530370025599,214.85
"J Fogarty","RF",751,2880,508,709,110,55,20,320,351,327,325,0,0.246,0.335,0.343,0.671474582172702,989,0.097,1.07339449541284,325,100,3231,828,0.328071804394924,0.343402777777778,144
"L Blanks","SS",629,1766,203,446,57,14,20,172,132,178,9,7,0.253,0.302,0.335,0.63918567198947,591,0.082,0.741573033707865,16,56.25,1898,375,0.304531085353003,0.334654586636467,88.3
"J Uribe","SS",1038,3064,307,738,99,34,19,219,256,425,74,46,0.241,0.3,0.314,0.613366258768757,962,0.073,0.602352941176471,120,61.6666666666667,3320,526,0.299397590361446,0.313968668407311,161.263157894737
"A Bannister","2B",972,3007,430,811,143,28,19,288,292,318,108,37,0.27,0.334,0.355,0.689182450204852,1067,0.085,0.918238993710692,145,74.4827586206897,3299,718,0.334343740527433,0.354838709677419,158.263157894737
"B Urbanski","SS",763,3046,379,791,123,27,19,207,198,252,24,0,0.26,0.309,0.337,0.641377424497208,1025,0.077,0.785714285714286,24,100,3244,586,0.304870530209618,0.33650689428759,160.315789473684
"J VanMeter","2B",300,743,83,153,38,5,19,79,88,208,17,5,0.206,0.293,0.347,0.637252948902958,258,0.141,0.423076923076923,22,77.2727272727273,831,162,0.290012033694344,0.347240915208614,39.1052631578947
"J Suwinski","CF",107,330,45,66,11,0,19,38,41,116,4,2,0.2,0.295,0.406,0.694470309564649,134,0.206,0.353448275862069,6,66.6666666666667,371,83,0.288409703504043,0.406060606060606,17.3684210526316
"E Fitz Gerald","C",808,2086,199,542,82,10,19,217,185,235,9,6,0.26,0.323,0.336,0.656173149887299,701,0.076,0.787234042553192,15,60,2271,416,0.320123293703214,0.336049856184084,109.789473684211
"J Riddle","SS",252,745,72,166,31,5,19,80,39,173,1,5,0.223,0.261,0.354,0.615842007944117,264,0.131,0.225433526011561,6,16.6666666666667,784,152,0.261479591836735,0.354362416107383,39.2105263157895
"C Bethancourt","C",264,793,82,184,37,0,19,80,31,200,8,5,0.232,0.263,0.351,0.611489795418651,278,0.119,0.155,13,61.5384615384615,824,162,0.260922330097087,0.350567465321564,41.7368421052632
"J Finigan","3B",512,1600,195,422,74,17,19,168,190,176,8,13,0.264,0.342,0.367,0.708774441340782,587,0.103,1.07954545454545,21,38.0952380952381,1790,363,0.341899441340782,0.366875,84.2105263157895
"W Difo","SS",492,1179,158,295,36,14,19,103,106,258,24,5,0.25,0.311,0.353,0.664903647818669,416,0.103,0.410852713178295,29,82.7586206896552,1285,261,0.312062256809339,0.35284139100933,62.0526315789474
"L Twitchell","LF",639,2571,362,676,103,40,19,384,168,231,84,0,0.263,0.313,0.356,0.664423260028552,916,0.093,0.727272727272727,84,100,2739,746,0.308141657539248,0.356281602489304,135.315789473684
"B Ryan","SS",896,2591,304,604,116,18,19,203,198,490,67,25,0.233,0.294,0.314,0.601336728524519,813,0.081,0.404081632653061,92,72.8260869565217,2789,507,0.287558264610972,0.313778463913547,136.368421052632
"H Alberto","SS",459,1322,149,360,70,8,19,121,32,169,12,7,0.272,0.294,0.38,0.66999667036874,503,0.108,0.189349112426035,19,63.1578947368421,1354,270,0.289512555391433,0.380484114977307,69.5789473684211
"A Miles","2B",932,2827,347,793,110,18,19,229,162,294,30,18,0.281,0.32,0.352,0.671821794877409,996,0.071,0.551020408163265,48,62.5,2989,576,0.319504851120776,0.352316943756632,148.789473684211
"J McTamany","CF",813,3102,693,794,135,58,19,334,535,158,255,0,0.256,0.373,0.355,0.720665727469324,1102,0.099,3.38607594936709,255,100,3637,1027,0.365411053065713,0.355254674403611,163.263157894737
"B Rowell","2B",574,1901,200,523,95,26,19,217,113,105,37,0,0.275,0.316,0.382,0.698219773526399,727,0.107,1.07619047619048,37,100,2014,417,0.315789473684211,0.382430299842188,100.052631578947
"Y Hernandez","LF",218,595,66,159,27,1,19,79,42,145,5,1,0.267,0.315,0.412,0.72730630713824,245,0.145,0.289655172413793,6,83.3333333333333,637,145,0.315541601255887,0.411764705882353,31.3157894736842
"D DeShields","OF",601,1828,302,450,81,19,19,139,211,487,111,32,0.246,0.327,0.342,0.666629284746137,626,0.096,0.433264887063655,143,77.6223776223776,2039,441,0.324178518881805,0.342450765864333,96.2105263157895
"M Harris II","CF",117,424,77,126,28,3,19,65,23,108,20,2,0.297,0.341,0.512,0.845125786163522,217,0.215,0.212962962962963,22,90.9090909090909,447,142,0.333333333333333,0.511792452830189,22.3157894736842
"S Taguchi","LF",672,1369,197,382,74,7,19,163,102,195,39,12,0.279,0.332,0.385,0.71398039228344,527,0.106,0.523076923076923,51,76.4705882352941,1471,360,0.329027872195785,0.384952520087655,72.0526315789474
"M Bumgarner","P",372,633,54,109,19,0,19,65,49,284,0,0,0.172,0.232,0.292,0.523930637980477,185,0.12,0.172535211267606,0,0,682,119,0.231671554252199,0.292259083728278,33.3157894736842
"W Roettger","LF",599,1949,192,556,96,23,19,245,99,143,4,0,0.285,0.324,0.387,0.70720236138725,755,0.102,0.692307692307692,4,100,2048,437,0.31982421875,0.38737814263725,102.578947368421
"D Anderson","SS",873,2026,244,490,73,12,19,143,206,331,49,30,0.242,0.312,0.318,0.629695676633867,644,0.076,0.622356495468278,79,62.0253164556962,2232,387,0.311827956989247,0.31786771964462,106.631578947368
"O Cruz","SS",92,350,49,84,13,4,19,60,30,131,10,4,0.24,0.3,0.463,0.762857142857143,162,0.223,0.229007633587786,14,71.4285714285714,380,109,0.3,0.462857142857143,18.4210526315789
"B Lillibridge","2B",358,708,102,145,25,4,19,71,49,235,37,14,0.205,0.267,0.332,0.588195672779109,235,0.127,0.208510638297872,51,72.5490196078431,757,173,0.256274768824306,0.331920903954802,37.2631578947368
"H Winningham","CF",868,1888,212,452,69,26,19,147,157,417,105,53,0.239,0.296,0.334,0.631485951680411,630,0.095,0.376498800959233,158,66.4556962025316,2045,359,0.297799511002445,0.333686440677966,99.3684210526316
"S Lyons","CF",853,2162,264,545,100,17,19,196,156,364,42,32,0.252,0.301,0.34,0.642841407669855,736,0.088,0.428571428571429,74,56.7567567567568,2318,460,0.302415875754961,0.340425531914894,113.789473684211
"T Saladino","3B",326,978,109,221,33,6,19,92,62,247,28,13,0.226,0.278,0.33,0.602381233286141,323,0.104,0.251012145748988,41,68.2926829268293,1040,201,0.272115384615385,0.330265848670757,51.4736842105263
"M Livingston","C",562,1490,128,354,56,9,19,153,144,141,7,0,0.238,0.31,0.326,0.630276917516204,485,0.088,1.02127659574468,7,100,1634,281,0.304773561811506,0.325503355704698,78.4210526315789
"M Rickert","LF",402,1149,139,284,45,9,19,145,88,161,4,1,0.247,0.302,0.352,0.652337662429036,404,0.105,0.546583850931677,5,80,1237,284,0.300727566693614,0.351610095735422,60.4736842105263
"H Rice","LF",424,1183,129,307,52,12,19,162,94,133,1,7,0.26,0.314,0.372,0.68595298442898,440,0.112,0.706766917293233,8,12.5,1277,291,0.314017227877839,0.371935756551141,62.2631578947368
"L Limmer","1B",209,530,66,107,19,4,19,62,63,77,3,3,0.202,0.285,0.36,0.647055267428171,191,0.158,0.818181818181818,6,50,593,128,0.286677908937605,0.360377358490566,27.8947368421053
"M Lee","SS",922,2693,304,686,88,20,19,249,201,531,31,20,0.255,0.305,0.323,0.629927316745069,871,0.068,0.378531073446328,51,60.7843137254902,2894,553,0.306496199032481,0.323431117712588,141.736842105263
"Y Benitez","LF",169,448,47,109,16,3,19,60,25,106,4,6,0.243,0.29,0.42,0.702940954394443,188,0.177,0.235849056603774,10,40,473,107,0.283298097251586,0.419642857142857,23.5789473684211
"B Lamar","LF",550,2040,305,633,114,23,19,245,86,78,25,27,0.31,0.339,0.417,0.754860457823769,850,0.107,1.1025641025641,52,48.0769230769231,2126,550,0.338193791157103,0.416666666666667,107.368421052632
"L Stringer","2B",409,1196,148,290,49,10,19,122,121,192,7,0,0.242,0.313,0.348,0.659898979895018,416,0.106,0.630208333333333,7,100,1317,270,0.312072892938497,0.347826086956522,62.9473684210526
"C Abbey","CF",451,1751,307,492,67,46,19,280,167,105,93,0,0.281,0.351,0.404,0.747927446791912,708,0.123,1.59047619047619,93,100,1918,587,0.343587069864442,0.40434037692747,92.1578947368421
"D Wilber","C",299,720,67,174,35,7,19,115,44,96,1,1,0.242,0.286,0.389,0.674229203025015,280,0.147,0.458333333333333,2,50,764,182,0.285340314136126,0.388888888888889,37.8947368421053
"N Punto","2B",1163,3253,421,798,141,27,19,263,386,651,104,36,0.245,0.323,0.323,0.648143084274967,1050,0.078,0.592933947772657,140,74.2857142857143,3639,684,0.325364111019511,0.322778973255457,171.210526315789
"J Koppe","SS",578,1606,202,379,61,12,19,141,209,345,16,13,0.236,0.324,0.324,0.648375410392845,521,0.088,0.605797101449275,29,55.1724137931034,1815,343,0.32396694214876,0.324408468244085,84.5263157894737
"C Kluttz","C",656,1903,172,510,90,8,19,212,132,119,5,0,0.268,0.318,0.354,0.669131243697718,673,0.086,1.10924369747899,5,100,2035,384,0.315479115479116,0.353652128218602,100.157894736842
"W DeLancey","C",219,598,79,173,32,10,19,85,85,74,1,0,0.289,0.38,0.472,0.849317147935774,282,0.183,1.14864864864865,1,100,683,164,0.377745241581259,0.471571906354515,31.4736842105263
"J Delahanty","2B",1095,4091,520,1159,191,59,19,489,378,24,151,0,0.283,0.357,0.373,0.716694309406187,1525,0.09,15.75,151,100,4469,1009,0.343924815394943,0.372769494011244,215.315789473684
"A Hyzdu","CF",221,358,54,82,18,0,19,61,41,98,1,1,0.229,0.31,0.439,0.746818162725249,157,0.21,0.418367346938776,2,50,399,115,0.308270676691729,0.43854748603352,18.8421052631579
"L Quinones","3B",442,1003,102,227,36,11,19,106,75,154,9,9,0.226,0.282,0.341,0.621125491799185,342,0.115,0.487012987012987,18,50,1078,208,0.280148423005566,0.340977068793619,52.7894736842105
"C Quintana","1B",438,1376,163,380,59,1,19,165,153,207,3,2,0.276,0.35,0.362,0.710512456842137,498,0.086,0.739130434782609,5,60,1529,328,0.348593852190974,0.361918604651163,72.4210526315789
"G Gil","C",277,820,67,189,30,0,19,88,47,162,2,2,0.23,0.276,0.337,0.608788364700256,276,0.107,0.290123456790123,4,50,867,155,0.272202998846597,0.336585365853659,43.1578947368421
"J Murphy","C",284,680,69,146,32,1,18,61,43,221,0,0,0.215,0.262,0.344,0.605528435440566,234,0.129,0.194570135746606,0,0,723,130,0.261410788381743,0.344117647058824,37.7777777777778
"T Stephenson","C",193,544,86,162,31,0,18,87,56,132,1,0,0.298,0.37,0.454,0.817377450980392,247,0.156,0.424242424242424,1,100,600,173,0.363333333333333,0.454044117647059,30.2222222222222
"J Pierre","CF",1994,7525,1075,2217,255,94,18,517,464,479,614,203,0.295,0.343,0.361,0.696250883170339,2714,0.066,0.968684759916493,817,75.1529987760098,7989,1592,0.335586431343097,0.360664451827243,418.055555555556
"J Whitney","P",550,2144,316,559,113,39,18,280,161,211,20,0,0.261,0.313,0.375,0.68736442516269,804,0.114,0.76303317535545,20,100,2305,596,0.31236442516269,0.375,119.111111111111
"D Kenworthy","2B",17,989,159,301,71,21,18,146,67,77,61,0,0.304,0.36,0.473,0.821690106321047,468,0.169,0.87012987012987,61,100,1056,305,0.348484848484849,0.473205257836198,54.9444444444444
"B Wilson","C",386,932,83,189,40,0,18,102,70,227,0,3,0.203,0.258,0.304,0.562131102601664,283,0.101,0.308370044052863,3,0,1002,185,0.258483033932136,0.303648068669528,51.7777777777778
"B Keister","SS",334,2433,400,758,133,63,18,400,90,5,131,0,0.312,0.349,0.44,0.776305095464513,1071,0.128,18,131,100,2523,800,0.336107808164883,0.44019728729963,135.166666666667
"G Browne","RF",1103,4300,614,1176,119,55,18,303,259,1,190,0,0.273,0.318,0.339,0.654064334793942,1459,0.066,259,190,100,4559,917,0.314762009212547,0.339302325581395,238.888888888889
"K Hayes","3B",259,964,121,249,52,7,18,90,88,232,30,6,0.258,0.324,0.383,0.703122288310746,369,0.125,0.379310344827586,36,83.3333333333333,1052,211,0.320342205323194,0.382780082987552,53.5555555555556
"R Andino","2B",481,1344,159,313,58,1,18,97,113,313,24,12,0.233,0.294,0.318,0.610089939373141,427,0.085,0.361022364217252,36,66.6666666666667,1457,256,0.292381606039808,0.317708333333333,74.6666666666667
"D White","3B",1299,5335,849,1619,217,73,18,756,292,215,46,0,0.303,0.344,0.382,0.721243322586625,2036,0.079,1.35813953488372,46,100,5627,1605,0.339612582192998,0.381630740393627,296.388888888889
"S Wooten","1B",267,669,66,182,28,1,18,86,37,120,4,4,0.272,0.314,0.398,0.707806670985827,266,0.126,0.308333333333333,8,50,706,152,0.310198300283286,0.397608370702541,37.1666666666667
"J Price","C",261,602,58,129,22,0,18,71,62,70,0,0,0.214,0.287,0.341,0.628182163871433,205,0.127,0.885714285714286,0,0,664,129,0.287650602409639,0.340531561461794,33.4444444444444
"J Jeter","CF",336,873,108,213,27,10,18,69,46,237,28,16,0.244,0.283,0.36,0.641507340889233,314,0.116,0.194092827004219,44,63.6363636363636,919,177,0.281828073993471,0.359679266895762,48.5
"H Jennings","SS",173,4904,994,1528,232,88,18,840,347,117,341,0,0.312,0.39,0.406,0.76286603375167,1990,0.094,2.96581196581197,341,100,5251,1834,0.357074842887069,0.4057911908646,272.444444444444
"A Recker","C",206,552,55,110,28,0,18,70,60,193,3,2,0.199,0.283,0.348,0.6256038647343,192,0.149,0.310880829015544,5,60,612,125,0.277777777777778,0.347826086956522,30.6666666666667
"H Spilman","1B",563,810,96,192,34,1,18,117,81,126,1,2,0.237,0.306,0.348,0.654545454545455,282,0.111,0.642857142857143,3,33.3333333333333,891,213,0.306397306397306,0.348148148148148,45
"C Jamieson","LF",1786,6560,1064,1990,322,80,18,552,748,345,131,110,0.303,0.378,0.385,0.759718884750424,2526,0.082,2.16811594202899,241,54.356846473029,7308,1616,0.374657909140668,0.385060975609756,364.444444444444
"P Daley","C",391,1084,93,259,49,8,18,120,87,187,2,2,0.239,0.297,0.349,0.644182440970439,378,0.11,0.46524064171123,4,50,1171,213,0.295473953885568,0.348708487084871,60.2222222222222
"Y Tsutsugo","1B",182,557,65,110,21,2,18,75,74,172,0,1,0.197,0.291,0.339,0.630918407702572,189,0.142,0.430232558139535,1,0,631,140,0.291600633914422,0.339317773788151,30.9444444444444
"M Treanor","C",468,1272,120,281,45,4,18,129,147,286,5,6,0.221,0.313,0.305,0.606652306301275,388,0.084,0.513986013986014,11,45.4545454545455,1419,249,0.301620859760395,0.30503144654088,70.6666666666667
"A Blanco","2B",536,1191,137,305,73,9,18,109,79,202,5,13,0.256,0.31,0.378,0.680195957873024,450,0.122,0.391089108910891,18,27.7777777777778,1270,246,0.302362204724409,0.377833753148615,66.1666666666667
"M Beaty","OF",261,547,85,136,25,3,18,92,41,100,7,2,0.249,0.32,0.404,0.705042346006044,221,0.155,0.41,9,77.7777777777778,588,177,0.301020408163265,0.404021937842779,30.3888888888889
"W Bloomquist","SS",1055,2891,398,778,110,23,18,225,189,494,133,51,0.269,0.316,0.342,0.655711298386843,988,0.073,0.382591093117409,184,72.2826086956522,3080,623,0.313961038961039,0.341750259425804,160.611111111111
"E Crane","P",391,1409,199,335,45,15,18,84,86,191,29,0,0.238,0.283,0.329,0.610916919658858,464,0.091,0.450261780104712,29,100,1495,283,0.281605351170569,0.32931156848829,78.2777777777778
"C Bigbee","LF",1148,4192,629,1205,139,75,17,324,344,161,182,68,0.287,0.345,0.369,0.710049460128977,1545,0.082,2.13664596273292,250,72.8,4536,953,0.341490299823633,0.368559160305344,246.588235294118
"C Roseman","CF",681,2761,443,726,120,49,17,222,133,41,19,0,0.263,0.312,0.36,0.657197684101816,995,0.097,3.24390243902439,19,100,2894,665,0.296821008984105,0.360376675117711,162.411764705882
"R Roenicke","CF",527,1076,141,256,51,3,17,113,190,195,24,9,0.238,0.353,0.338,0.690580642130176,364,0.1,0.974358974358974,33,72.7272727272727,1266,254,0.352290679304897,0.338289962825279,63.2941176470588
"J Mateo","SS",263,721,89,163,39,8,17,68,39,214,50,12,0.226,0.273,0.373,0.638882400175195,269,0.147,0.182242990654206,62,80.6451612903226,760,157,0.265789473684211,0.373092926490985,42.4117647058824
"F Cabrera","1B",196,351,32,89,17,1,17,62,21,69,2,1,0.254,0.294,0.453,0.748690377722636,159,0.199,0.304347826086957,3,66.6666666666667,372,94,0.295698924731183,0.452991452991453,20.6470588235294
"J Pirela","LF",302,909,113,234,55,8,17,82,63,196,11,7,0.257,0.308,0.392,0.697194719471947,356,0.135,0.321428571428571,18,61.1111111111111,972,195,0.305555555555556,0.391639163916392,53.4705882352941
"J Lake","OF",223,659,65,155,36,3,17,48,35,218,16,7,0.235,0.278,0.376,0.650102985485825,248,0.141,0.160550458715596,23,69.5652173913043,694,113,0.273775216138329,0.376327769347496,38.7647058823529
"N Green","2B",418,1078,147,254,58,5,17,103,80,286,6,11,0.236,0.303,0.346,0.634439456423172,373,0.11,0.27972027972028,17,35.2941176470588,1158,250,0.288428324697755,0.346011131725417,63.4117647058824
"S Livingstone","3B",673,1533,163,431,76,4,17,177,89,189,10,12,0.281,0.317,0.369,0.689802559876711,566,0.088,0.470899470899471,22,45.4545454545455,1622,340,0.32059186189889,0.369210697977821,90.1764705882353
"E Burton","CF",215,556,79,120,24,4,17,59,65,117,11,6,0.216,0.3,0.365,0.663014515923493,203,0.149,0.555555555555556,17,64.7058823529412,621,138,0.297906602254428,0.365107913669065,32.7058823529412
"C Dickerson","LF",355,721,105,185,35,7,17,66,83,231,35,7,0.257,0.335,0.395,0.728617660656496,285,0.138,0.359307359307359,42,83.3333333333333,804,171,0.333333333333333,0.395284327323162,42.4117647058824
"E Wynn","P",796,1704,136,365,59,5,17,173,141,330,1,0,0.214,0.274,0.285,0.558879155692965,485,0.071,0.427272727272727,1,100,1845,309,0.274254742547425,0.28462441314554,100.235294117647
"P Dougherty","LF",1233,4558,678,1294,138,78,17,413,378,0,261,0,0.284,0.346,0.36,0.698323356870532,1639,0.076,Inf,261,100,4936,1091,0.338735818476499,0.359587538394032,268.117647058824
"J Smith","2B",278,576,65,122,15,10,17,60,23,181,9,4,0.212,0.248,0.361,0.603181227972547,208,0.149,0.12707182320442,13,69.2307692307692,599,125,0.242070116861436,0.361111111111111,33.8823529411765
"C Donnels","3B",450,798,83,186,36,5,17,86,103,165,5,1,0.233,0.319,0.355,0.675391308459829,283,0.122,0.624242424242424,6,83.3333333333333,901,169,0.320754716981132,0.354636591478697,46.9411764705882
"C Reilly","3B",641,2380,342,595,80,24,17,311,180,161,132,0,0.25,0.314,0.325,0.627944459033613,774,0.075,1.11801242236025,132,100,2560,653,0.302734375,0.325210084033613,140
"R Theriot","SS",899,3246,446,911,138,18,17,257,285,383,121,49,0.281,0.341,0.35,0.688683438109043,1136,0.069,0.744125326370757,170,71.1764705882353,3531,703,0.338714245256301,0.349969192852742,190.941176470588
"J Bowker","1B",240,574,54,133,25,5,17,73,39,136,2,3,0.232,0.283,0.382,0.662120376738608,219,0.15,0.286764705882353,5,40,613,127,0.280587275693312,0.381533101045296,33.7647058823529
"K Garlick","LF",144,319,48,73,16,0,17,37,19,106,1,0,0.229,0.281,0.439,0.711060822466658,140,0.21,0.179245283018868,1,100,338,85,0.272189349112426,0.438871473354232,18.7647058823529
"J Bucher","3B",554,1792,242,474,66,19,17,193,91,113,19,6,0.265,0.302,0.351,0.651057571030271,629,0.086,0.805309734513274,25,76,1883,435,0.300053106744557,0.351004464285714,105.411764705882
"R Derry","LF",187,553,68,124,17,7,17,73,78,124,2,0,0.224,0.322,0.373,0.692640345271291,206,0.149,0.629032258064516,2,100,631,141,0.320126782884311,0.37251356238698,32.5294117647059
"M Kittridge","C",470,4027,375,882,108,31,17,390,314,166,64,0,0.219,0.277,0.274,0.549413721832823,1103,0.055,1.89156626506024,64,100,4341,765,0.275512554710896,0.273901167121927,236.882352941176
"G DeMontreville","2B",280,3615,537,1096,130,35,17,497,174,35,228,0,0.303,0.34,0.373,0.707794894371017,1347,0.07,4.97142857142857,228,100,3789,1034,0.3351807864872,0.372614107883817,212.647058823529
"L Niekro","1B",195,499,61,123,26,5,17,79,29,91,0,2,0.246,0.288,0.421,0.708720471245521,210,0.175,0.318681318681319,2,0,528,140,0.287878787878788,0.420841683366733,29.3529411764706
"B Whitehead","2B",924,3316,415,883,100,31,17,245,150,138,51,0,0.266,0.304,0.331,0.628556781472544,1096,0.065,1.08695652173913,51,100,3466,660,0.298038084246971,0.330518697225573,195.058823529412
